fabandono → ekoretio
abanico →  abaniko, cuenda
abastecedor → rekarette
abastecimiento → rekaratio
abastecimiento → rekarotio
abdomen → abdomo
abdominal → abdomonexo
abecedario →  letratablo
abedul → atria
abeja → blaimallea
aberración → aberratio
abertura → aipreixo
abeto → karzua
encuesta → contesta
abadía → abia
abismo → abystela
recubrimiento, cápsula, protección, trinchera, nido, bunker, guarida → laira
cápsula → capsula
abogado, legista → abvogette
abolladura, abollón → hundo
abono (abonar dinero) → abono
abono (tierra) → tseso
abordaje → aborratio
balanza → balante
aborto → aborto
previsualización → previso
previsión → prevo
abracadabra → magika ragika
abrazo → hogo
disfraz → desfro, vanga
abrebotellas → aiprebotelo
abarca → abarka
coartada → quartada
Abril → Aiprila
desfile → deslina
abstención → abstena
abuela → meioko
abuelo → umoko
gaviota → tagaro
abundancia → abontia
aburrimiento → aborraitio
acacia → akacea
academia → akademia, academos
dinamita → dinamita
acampada → akempa
ácaro → atiko
cuatriciclo → quatroda
advertencia → varno
alfombra → corta
moqueta → moquete
brillo → brio
brío, garbo → farla
accesibilidad → akcesibila
acceso → akciso
acción rápida → rante aktio
acción → aktio
aceitera → asonexo
aceite → asoa
aceleración → acelereitio
mofeta → napesta
acelerador → aceleoro
acero → akero
acero → azero
acogida → akaina
acompañamiento → akompanniretio
acondición → akonditia
acordeón → acordeon
acrobacia → akrobatia
acróbata → akroxette
activación → aktivatio
actividad → aktivita
actor → actor
acto → akto
actriz → actoras
actuación → aktoatio
actualización → airposo
acuario → acoario
acuerdo → akordo
acusativo → akusative
adicción → adiktia
adición → ado
administrador → administreiette
adobe → adobe
adonis (flor) → adonis
adoración → adoro
adverbio → adverba
aeróbic → aerobika
aeropuerto → aerporto
afección → afektio
afecto → afekto
afeitadora → xaveioro
afeitamiento → xava
Afganistán → Afganistan
Afgano → Afgano
afijo → afixe
afilación → alfilatio
fila → linia
afirmación → aiatio
África → Afrika
agache → prige
agencia → agentia
Agosto → Agaisto
agradecimiento → grazeizero
agricultor → agrikulxette
agricultura → agrikultura
agrupación → agrupatio
aguacate → guacafruki, aguaco
aguante → jena
guante → luva
agua → acoa
aguijón → estungo
águila → egila
agujero de bala → racobale
agujero → raco
aidanacia → aidanakia
aidanés → aidanesa
aire acondicionado → aerakonditiaoro
aire → aer
ajuste → rikro
álamo → klisila
alarma → alarme
Albanés → Albanexe
Albania → Albanea
albinismo → albinisma
albino → albino
alce → bazerra
alcohol → etanol, altsol
aldeano → aldeano
aldea → aldea
bazar → bazar, baziar
fular → fulard
alegría → aibe
Alemania → Duxlan
Alemán → Duxleano
alimentación → flomo, nisigo
alimento → flomiga, nisingo
alineación → aliniatio
almacenaje → esmariun
azar → runge
aleatoriedad → rungia
almacenamiento → esmaretio
almacén → esmareitela
alma → anima
almeja → matsasa
almena → almena
agonía → agonia
almendra → almondra
almidón → amilone
almohada → bexe
alquitrán → betarra
altar → altar
altavoz, parlante → sonikemitero
alternativa → alternas
altura → aitora
alucinación → alutination
amanecer → amanza
amanecer → solnata
amanita → amanita
amante → loiere
amapola → maploa
amaranto (flor) → amaranto
amargado → tsagrioso
amatista → amatista
América → amerika
ametralladora → metrallaro
amigo, amiga → amike, amiko, amika
amigo con derecho → rotsenko
amistad → amikia
amor → loi
amputación → amputatio
amputación → unmembria
anarquía → anarqia
andador → andaivo
andén → vaden
andesita → andesita
Andorrano → Andorreo
Andorra → Andorra
androide → androido
anémona (flor) → anomas
ángel → anyel
angila → gistomo
Angolano → Angolaneo
Angola → Angola
anguila → zegor, zangela
anillo → rinka
animal → animal, besta
aniversario → yaroia
anochecer → nitoia
anomalía → anomalia
año → yaro, anio
Antártida → Antartika
antibiótico → antibiotiko
antifaz → antifaz
Antiguano → Antiguaneo
Antigua y barbuda → antigua e barbuda
antiguedad → antiaga
antorcha → tortsa
anuario → yarizboto
anuncio → adva
apagamiento → ofetio
apagón → deof
aparición → aparezeitio
apeadero → apeadela
apellido → aurnome, ginome
apertura → aipreio
apicultor → apikulxette
apicultura → apikultura
aplicación → aplikatio
apodo → xenome
aprendizaje → aprendeixo
aprobación → aprovatio
aprobado → aprovo
apuñalada → estava
apuñalamiento → estavo
Árabe → Arabeka
Arabia Saudita → Arabika Saudita
araña → vesuka
arándano → aniluba
arboleda → arbotsiun
árbol → arbotso
arbusto rodante → erbusto da deserto
arbusto → erbusto
rendición → purna
desengrasante → torqera
desengrasador → torqette
arce → gizalda
archipiélago → artsipelago
archivo → file
arcilla → clugra
arcoiris → kolorarico
arco → arketo
aurora → aurora
area → area
arenas movedizas → auxarran
arena → auxa
barrote → furne
Argelia → Argelia
Argelino → Argelineo
Argentina → Argentia
Argentino → Argento
armadillo → puntsirra, armado
busto → perpetro
armadura → armatsosto
armario → orraqe
arma → arma
arma → armatia
Armenia → Armenia
Armenio → Armeno
arqueología → arqeologia
arqueologo → arqeologe
arranque → arrantsa
arreglo → reparo
arte → arte
ascensor → airoro
ascenso → ansenno
Asia → Asia
asiento → asenda
asno → ostoro
aspecto → aspectia
aspiración → aspira
aspiradora → aspiraoro
aspirina → anfluga
astato → astato
astronauta → astronatte
astro → astro
ataque al corazón → koraisagra
ataque → atakte, atake
atardecer → tarena
atención → atentio
ático → airgaizera
atril → lekteoro
atrio → atrio
atún → tunna
pergamino → perge
audífono → audefono
audio → audeo
aullido → ulule
aumento → easa
varita → vando
aura → auram
auricular → oitosono
autismo → autisma
autobús → autobus
autor → autora
avaricia → avaritia
avenida → avenua
aventura → ventura
avestruz → otsorra
avión → avionno
aviso → avisto
ayuda → lade
azafrán (flor) → aziala
azahar (flor) → azaharo
barricada → barraca
azúcar → sukra, sucra
azul celeste → acoa
azulejo → eskala
badén → batino
bahía → baheia
baile → danze
bajada → aura
bala → bale
ballena → argeya, baola
baloncesto → bolacesta
bambú → bambo
banco (edificio) → banko
banco (sentarse) → sendaia
bandeja → indaksa
bandera → fliaga
bañera → bax
baño (lugar) → mertaitela
baño (referencia a objeto) → mertaioro
banquero → bankexette
banquete → banqete
baraja → baraja
bárbaro → barbaro
Barcelona → Barcelona
barco → barco
barra → cana, baferro
barrera → barrera
barrido → furre
barril → barrila, tondra
base → base
bastilla → bastila
bastión → baluaro, bastiraa
bastón → baton
batalla → bataila
batido → socrema
bauxita → bauksit
baya → eruba
bazooka → bazuka
bebé → beko
bebida → acoixo
brizna → hebra
bégimo → behemuto, bemoz
begonia (flor) → begonna
Bélgica → Belgia
belleza → belesa
bendición → bendizatio
beneficio → benefitio
bengala → bengala
berenjena → isaloa
Berlin → Berline
berlina → berlina
beso → beso
bestia → besta
biblioteca → bibloteka
bicho → tiko
bicicleta → birroda
bioma → bioma
bisabuela → bismeioko
bisabuelo → bisumoko
bisagra → izoya
bisexual → bisexualo
bisexualidad → bisexualita
bismuto → bismuto
bisonte → bisonte
bloqueo → lokeo
bloque → bloke
boa → zisga
bocadillo → britango
boca → oupa
bola de nieve → aigebola
boleto → fixola
boletus → boletus, mastufa
bolígrafo → tentaoro
bollería → bunaria
bollo → bollo
bollo → bun
bolsa → baga
bolsillo → pokete
bombardero → bombardoro
bomba → bomba
bombero → ignoextingette
bombilla → bulba
bombona → butanna
bombón → tsoklo
boquilla → oupila
borde → asero
borrador (boceto) → druxeto
borrador (herramienta) → prusaioro 
bosque → fisi, arbotsiun
bota → bota
botella → botelo
bote → bote
botón → botonna
branquia → brankia
Brasileño → Brazilenno
Brasil → Brazil
brazalete → airoie
brazo → airo
bricolaje → bricolagia
brisa → briza
broche → brutsio
añalejo → relicrolista
broma → rusa
bromelia (flor) → estarola
bromo → bromo
bronce → bronce
Bucarest → Bukaresti
budismo → budisma
buey → zarra
búfalo → bufalo
bufanda → bunfaza
bufón → bulanere, xiabette
cartilla → cartila
búho → ebande
buitre → xikorra
buque → buqe, dunko
burgo → burge
burla → bula, vanka
burro → zigar
buscador (cosa) → findaoro
buscador (persona) → findette
búsqueda → findo
butaca → cansenda
butano → butano
caballito de mar → marayato
infracción → frakza
caballo → ayato
veto → bana, paina, paine
cabeza → antsasa. casca
cabina → cabin
cable → guiro, tokla
cabra → koato
camisón → camiso
cabrón → morogo
cacahuete, cacahuate → cacauato
caca → nnordo, fecta
tarjeta, carta de naipe → carde
cacería → junziasa
cacerola → kaserola
caballero (que monta a caballo) → ayette
caballero (hombre) → vero
cactus → cactia
cada → kada
café → kafe
cagada → mertato
caida → arga
caja de herramientas → horocuba
caja fuerte → herrocuba
caja → cuba
cala (flor) → belania
calamar → kalatrono
calavera → antsoarko
calcetín → poitexo
calculadora → kalculoro
calefacción, calefactor → kaleria 
calendario → henlista
caléndula → calendula
calentamiento → kaleirisa
calle (referencia general) → estrato
callejero → estratoge
calle → kale
calor → kaler
calzoncillo → carkazono
camaleón → jideor
cámara → camera
camarero → hostexette
nido → nesta
cama → dormebas
cambio → kambio
camello → usatsa, camolo
camino → kemno, rata
camión → oxtokotse, lorro
camisa → kamisa
camiseta → kamiseta
campamento → akempo
campanero → campelette
campeonato → tsampeonato
campeón → tsampeon
campesino → campesette
campo → kempo
Canadá → Canadia
Canadá → Kanada
canal → kanala
urbanización → urbo
caña → kanna
cancelación → kanzelatio
cáncer → cancer
capilla → capela
carcelero → cartselette
canción → qanzio
candelabro → candalabro
hermanastro → inestholeko
hermanastra → inestmeileko
madrastra → inestmatrona
padrastro → inestpatrono
hijastro, hijastra → inesteko
abuelastra → inestmeioko
abuelastro → inestumoko
verruga → burgua
cangrejo → kraba
canguro → kangoro
canoa → canoia
cansancio →  infize
cantautor → qanzautora
catalejo → foreviso, forevo
cantera → petrotela
cantero → petroxette
cantico → qanzigo
cantimplora → acoino, cantimpla
cantina → cantena, ingotela
canto → qanzo
rebaño, ganado → eskio
ganadería → eskiaro
ganadero → eskiate
caoba → untsuaç
religión → relicro
reliquia → relicua
capa → elara
capital (ciudad) → enciuta
capital (dinero) → capital
capitalismo → capitalisma
capitán → captanna
cápsula → kapsula
captura → kapta
capullo (mariposa) → cucula
capullo → fasoa
asunto → reaso
caracol → itsa
cara → fazia
carbon → karbona, cocola
carburante → carburanto
carburo → carburo
carcaj → qiava
cárcel → cartsela, prison
chaleco → tselo
chelo → tselo
chamarra → burtso
cardo → tsardo
cargador → kargaoro
carga → karga
carisma → tsarisma
carnaval → carnavala
carne → karno
carnicero → karnirette
carpeta → folda
carpintero → madraxette
carrera (juego) → zurraion
carrera (universidad) → cursogra
carretera → rakemno
carta (texto) → letera
cartero → leteraette
casa → kasa
cascada → moana
cáscara (platano) → muzka
casco → antsal
caseta, cabaña → asunna, kasutsa
casilla → kasiya
casino → casino
castaña → nizaga
castaño → nizagal
casta → casta
cerrajero → klavikette
castigo → jusa
castillo → castil
soga → soka
castor → biatse
catarsis → katarsis
catastrofe → combe
cauce → calikso
causa → causa
cautividad → kautivita
caviar → haviar
cazador → junzette
caza → junze
cazo → xikara
cazuela → xikere
cebolla → onnete
cebra → zebra
cedro → citrua
celda → celar
célula → celula
cementerio → mortotela
pancreas → pancras
cena → hinge, yantaro
cencerro, campana → campela
ceniza → axa
centaurea (flor) → centara
centella → centela
centenario → ozenore
centeno → surtso
centro → zentro
cepillo de dientes → dentabrutsa
cepillo → sebrutsa
cerdo → porko, pigo
cerebro  → mentio
cereza → roxuba
cerradura → klavika
cerrojo → kerranda
cerveza → birraza
césped → briaxa
cesta → cesta
chaqueta → giaqeta
charco → culda
chat → chat
chica con derecho → rotsenmeia
chica → meia
chico con derecho → rotsenhone
chico → hone
Chile → Tsile
chimenea → tsimeneia
chimpancé → itsimp
China → Tsina
chincheta → pinna
chinchilla → tsintsila
Chino → Tsineo
chip → chip
chispa → kispa
chiste → zizga
chocolate → xouclate
chuche, caramelo → dultsina
chupada → lika
ciclismo → ciklisma
ciclo → ciklo
cielo (religión) → estelegas
cielo → kailo
ciencia → cientsa
científico → cientsette
ciervo → perlo
cifrado → cifrato
cienciología → cientsologia
cifra → cifra
cilindro → cilindro
cima → zima
cimitarra → escimitarra
cinta transportadora → aconveioro
círculo → circlo
circunstancia → zirkuntantia
ciruela → pluma
cisne → aista
cisterna → cesterna
ciudad → ciuta, ciutatela
claridad → klaritatio
cencerro → beletro
clase → klase
clasificación → clasifike
clavel → maira
chistera (sombrero de copa) → tsistera
clave → klave
clavija → klaviya
paracaídas → paratsute
lombriz → siguro
clavo → klaga
clemátide (flor) → espirita
cliente → komprairette
clima → climaia
cloroformo → cloroforme
comprensión → comprendo
compasión → compasion
cloro → cloro
conductor (vehículo) → drivette, conduktette
conductor (objeto) → conduktoro
cobre → ikroso
cocaína → cocaina
cocaína → kokaine
coche, auto, automóvil → kotse, vehiklo, automovo
cocido → kozido
cocina (lugar de cocinar) → koxineitela
cocina (termino general) → koxina
cocinero → koxinette
cocodrilo → crocus
cóctel → coktel
código → codiko
cofre, baúl → gaizecuba
cogida → kaina
cojín → zobexe
cola (animal) → urda
cola (personas) → qeola
colapso → colapso
colegio, escuela → esaroriun, eskola
cólera → xolera
colibrí → liarta
colina → yordea, sugal
colmena → bajiba
colocación → kolokatio
Colombia → Kolombia
colonia, perfume → dafuma
colonia (territorio) → colonia
artículo → articulo, articlo
colonización → colonicea
colono → colone
color → kolor, kromato
col → colta
coma (salud) → coma
coma (texto) → coma
crónica → cronike
comando → comando
comba → pulanda
combinación → combo
combustible → nitor, combustable
combustión → combustio
combusto → combusto
comedor → ingotela
comer (coloquial) → ingoi
meteorito, meteoro → meteoro

comercio → komerzio
comida → ingo
comodidad → conforta
compañero de cárcel → cartselenko
compañero de clase → klasenko
compañero de cuarto → itelenko
compañero de piso → blokenko
compañero → kompannette, enko
compañía → kompania
comparación → asletio
compartimentalización → kompartilazetio
compendio → compentio
complejo (instalaciones) → komplexo
complemento → komplimento
complexión → komplexio
comportamiento → unba
comprador → kompraixette
compra → kompra
comprobación → tseqe
comunidad → comunitatia
comunismo → comunisma
concha → akontse
condado → contia
conde → condo
condición → konditia
condón → kundonna
conducto → driveno, condukto
conejo → isgaro, buno
suceso → bero
conexión → conektio
confianza → dibla
configuración → configo
confusión → confuzio
congelador → gelaioro
conocimiento → aonatia
conquistador → conqeror
conquista → conqitia, conqista
conservación → conservatio
conservador → conservette
constelación → constelatio
construcción → tenda
constructor, arquitecto → tendaxette
contaminación → drigatio
contención → containio
contenido → contento
contexto → conteksto
contraseña → codivorto
control → control
conversación → pairetio
conversión → konversio
copa → cope
Copenague → Kopenage
copia → kopea
coque → coke
coral → arima
coraza → koraza
contribución → contribe
corazón → koraiso
corbata → corveta
corcho (material) → arkutsa, korko
corcho (panel de corcho) → arkutsaplane
corcho (tapón de botella) → arkutsa
cordón → cordo
corona → korona
corredor → zurrette
correo → maila
corrida (cualquier significado no sexual) → zurrata
corrupción → korruptio
corte → kuta
cosa → koixa
cosecha → cropo
costa → koasta
costra → ruxga
costura → ehelo
coyote → cuxate
cráneo → craneo
creación → creata
crecimiento → egra
artefacto → artefactum, artefacto
crédito (de crear algo) → credito
creencia → belei
crematorio → tsizirreitela
crema → crema
crepúsculo → horcasto
reactor → reactoro
reacción → reakto
cretino → filastra
criada → kraiette
cria → kraia
crisantemo → crisantemo
crisol → crucibla
cristal (mineral) → kristal
cristal (vidrio) → klisal, vitro
cristalería → klisalatia
cristalero → klisalaqe, vitreqe
cristianismo → kristianisma
cronómetro → klokometera
cruasán → croasan
cruce → crosa
cruz → crosa
parking, aparcamiento → parakia
cuadrado → qatrato
trato → tiska, trao
cuadrícula → qatratiko, griya
cuadro → kadro
cuártel → iritela
cuarto (habitación) → itela
quehacer → doidute
cuarto (tiempo o matemáticas) → quarto
cuásar → quasar
Cuba → Cuba
cubo → kubo
cubrimiento → kubraia
cucaracha → mustanekro, mikoro
cuchara → boutsara
cuchillo → akuttere, nivo
cuello → pisotsa
cuenco  → kisa
cuenta (números) → konta 
cuenta → akanta
cuerda → resta
cuerno → corno
cuerpo → corpo
cuervo → corvo
dama → dama, mena
cuestión → kuastion
cueva → encova
cuidado → culda
culo → anusa
culpa → riaxa
corpa → corpe
cultivo → kultivo
culto → culto
cultura → kultura, viri
cumpleaños → henyaro, natahen
cuña → cunna
cura ,  sacerdote → praisoxette
cura (antídoto) → kura
curiosidad → kurioseata
curso → curso
curva → vira
dado → dize
demonio → damon
daga → diaga
daño → daxa
seña → sinna
dársena → portakarga
dato → data
deber (algo que debes) → dute
deber (colegio) → esaroidute
decágono → decakono
decisión → deze
dedal → fakro gid
dedo → gid
defecto → defekto
defensa → defenda
destructor → distroro, distructor
disruptor → disruptor
disrupción → disrupta
defensor → defendette
deficiencia → defizientia
deidad → deida
disciplina, doctrina → discipula
discípulo → disciplo
delfín → delfino
democracia → democratia
dentadura → dentatia
dentista → dentaxette
dentríficio, pasta dental → dentacrema
dependencia → dependentia
depresión (montañas) → depresion
depresión (sentimientos) → depresia, depreia
depuración → puratio
derecha → dereite
derrame → derrame
desactivación → deaktivatio
desagrupación → unagrupatio
desaparición → unparezeitio
desaprobación → deaprovatio
desarrollo → deurrayo
desastre → disastra

descanso → hixe
descenso → densenno
desecho → desexo
desembarco → desbarco
desembocadura (río) → rioke
deseo → agux
desierto → deserto
deslizador → esleiner
cátodo → catodo
deslizamiento → esleia
desmayo → dizkoia
desnudo → abiare
destello → destelo
destino → desteno
destornillador → desexkraboro
destrucción → distro
desvario → desvario
detalle → detaila
calabazín → cumba
detergente → detergo
determinación → determinatia
deuda → dutia
diablo → devila
diagnóstico → diagnostiko
diagrama → deagrama
diamante → diamento
diana → nesiga
diario → hengia
día → hen
dibujo → dixo
diccionario → diktionario
dicho → dikero
Diciembre → Dicembro
dictador → dictatoro
dictadura → dictatura
diente de león (flor) → sedara
diente → denta
dieta → dieta
dificultad → derrenno
rección → rektio
digito → digito
dimensión → dimensia
dinero, pasta → moneta
diorita → diorita
diosa → deisa
dios → deis
diplomático → diplomaxette
diploma → diploma
dirección (hacia algo) → dirija
dirección (lugar) → direktia
director → dirijette
disco → diske
disparo → desparo
divisor → dipre
dispositivo → alitaro
disquete → diskete
recto → recto
rector → rektor
distancia → longara
distrito → distrikto
diversión → xiaibela
discriminación → discrima
divisa → divisa
división → diproxo
doctor → doktor
documento → dokumento
dodo → dodo
dolor → dole
Domingo → dominko
dormitorio → dormeiun
dragón → dracono
droga →  drojo
directiva → directiva
ducha → tsoaga
duda → duba
zumbido → biz
dueño, dueña → donno
ergonomía → ergonomia
empalme → apalme
duración → dula
ebullición, evaporación → inherba
oración → oratio
Ecuador → Equator
edición → editio
dólar → dolar
editor (persona) → editette
editor (programa u objeto) → editoro
Egipto → Egipto
ejemplo → exemplo
ejercicio → exersizo
electricidad → elektritia
electrón → elektronno
elefante → estsondo
embarcadero → embarcatero
embarco → embarco
emisor → emitero
empanado → ebrito
empanada → ebritaita
empanadilla → ebritaitita
empatía → maiso
emperador → emperos
emperatriz → emperas
empotración → empotratio
empresa → enterprisa, kompania
empuje → puja
encanto → enxanto, encanto
enchufe → pluga
enciclopedia → enciklopedia
enclave → entsave
energía → eneryia
discoteca → discotela, discoteka, disco
Enero → Januaro
paliza → puntsatarra
ajo → garlo
enfado → rutsu
enfermedad → ebila
enfermero → ebilaxette
enfriamiento → aigeisa
engaño → lerra
engranaje → giar
enlace → linke
ensalada → ensalada
entendimiento → enderia
entidad → entita
entierro → enterro
entrada → entratela
envío → dario
reenvío → redario
época → elkara
equivalente → eqivala
erizo → jedogo, pinkiporke
mazorca (maíz, por ejemplo) → bontso
rizo → rize
error → erra, mistaco, faio
taco → taco
burrito → burrito, kubrutso
talco → talco
escala → eskala
escalera → escalatorra
escama → eskama
escándalo → estantsa
escarabajo → karabajo
escena → estena
esclavo → eslavo
eslavo → eslava
escoba → furra
escobilla → furrisa
escolta → eskolta
escopetazo → buste
escopeta → busterre
escorpión → escorpio
escozor → eskozo
escrito → izkriba
escritura → izkribatia
escroto → escroto
escudo → seldo
escurrida → guta
escurridor → gutaoro
esencia → esentia
esmeralda → emeralda
espacio en blanco → biancara
espacio → espatio
espadaña → dragonkane
espada → raiyoa, suarda
espagueti → espageti
espalda → betranno
España → Espanna
Español → Espannol
especialidad → espezialitata
espectáculo → espectaclo
espectador → espekteixette
espejo → espelekto
esperantista → esperantesta
Esperanto → esperanto
esperanza → aikala
espera → herre
espesura → hexegia
espina → tira
espíritu → espirita
óculo → oculo
esposa → meixa
espuma → hixa
esquema → eskeme
esquinazo → eskinata
esquina → eskina
esquive → inze
establecimiento → establezimento
establo → ayatotela
estación (del año) → tempora
estación (tren) → parada
estadio → estadia
Estados Unidos → Estatioit Yoiko
estado → estatio
estafador → lerrako
estallido → aixo
estancia → estanzia
estandarte → estantaro
estaño → tenno
estantería → axelva
estante → axele
estar de pie, estante → estante
totem → totem
estatua → estatua
este → este
estiércol → tsisigra
estilo → estila
estalactita → espeleoka
estalagmita → espeleona
estimación → estimatio
fresón → frerna
estima → estima
estómago → ingeriun
Estonia → Estonia
Estonio → Estonesa
estrella de mar → marestrela
estrella → estrela
estrés → anorro
estructura → estrukta
estudiante → estarette
estudio → estaro
estúpido → esporgo
eternidad → ertsekoidae, ertse
ética → etika
etnia → etnia
Europa → europa
evento → evento.
exageración → hurro
examen → examen
examinación → examinatia
excitación → enuse
excusa → excusa
patada → poitsa
explanada → planiuno
tupla → tupla
explosión → bombeia
explosivo → explodoro
exportación → exporte
expresión → expresio
extensión → extentia
extintor → ignoextingoro
extraño, desconocido → estranne
extremo → extremo
eyaculación → guma
falda → fuana
falta → faita
familiar → pai
familia → pailako
favor → fevo
Febrero → Febrero
portero → portette
ecología → ecologia

fecha → daita
felicidad → aibela
feo → utego
fetiche → fetixa
feto → feto
fez → fez
fé → fai
gusano → guro
fibra → fibre
fideo → fixoa
fiebre amarilla → fever mallea
fiebre → fever
fiel → faiette
fiesta → festa, parta, faira
feria → faira
figura → figura
filo → fila
final → finale
fin de semana → finaolexo
fin → fin
fístula → fistula
flamenco → flamingo
flamenco → flaminko
fractal → fractal
flash → flash, flax, bliqa
flauta → fluta
flecha → fletsa
flora → flora
flor → floira
fluido → flogo
fobia → fobia
foca → purra
fogata → fogo
folclore → folklore
fondo → fondo
fonética → fonetika
formación → formatio
formato → formato
fragmento → fracto
forma → forma
fórmula → formula
fortuna → heleria
fosforo → fosfuro
fracción → fraktio
Francés → Francesa
Francia → Francea
francotirador → ardespaire
frase → zance
fregona → mope
freidora → friteoro
frente → urante

fresa → fresa, estserra, rutsia
fresia (flor) → calanula
fresno → katria
friki, sabido → goko
friki → weabu
licenciado → licenso
frío → aige
grieta, raja → raca
frisbee → frisbee
frito → frito
fruta → fruki
fucsia → fuksia
fuego → igno, foko
vitalidad → vitalita
fuelle → fluma
fuente → fonto
fuente (origen), origen → origo
fuerza → forza
fuga → fuga
fumador → esmokaiette
fundición → fuseitela
funeral → funeral
fusil → fusil
fútbol → futbola, poibola
futuro → proximo
consorcio → consortso
sólido → solido
consorte, cónyuge → conyuge
gafas → visoioroit
galería → galila
gallina → conto
gamba → ximbrarisa
gandúl → sugarriyo
ganso → guse
gardenia (flor) → gardenia
garrapata → giarrapoita
garra → giarra
gasolina → gasola, nitor
gas → gas
gato (animal) → kato
gato (herramienta) → criketa
gel → gel
gemelo → gineko
gemido → kemeido
generación → espauna
guarida → guardia
generador → espaunaoro
ardilla → esquiro, bunyo
general → general
género → genera
gente → gente
gen → gene
geranio (flor) → galina
geranio → alisla
gilipollas → sudatso
gimnasia → gimnasta
gimnasio → gimnastela
girafa → gerafe
licencia → licensa
girasol → solavisa
giro → viro
glaciar → gielplaniuno
gloria → gloria
gobierno → governo
gofre → xafla
golem → golem
golfo (geografía) → girufa
goma (herramienta) → prusaioro
goma (material) → goma
gorila → korila
gorra → capa
gorro → gorro
guardia → guarda
yero, algarroba → yero
grabación → grabatio, recordo
gracia →  graze
grado → grado
granito → granita
granizo → aigecombe
granja → granja
grasa → lipuda
gravedad → gravita
graznido → cuaqio, grazne
grifo (agua) → espigoto
grifo (animal) → grifo
grillo → audixora
idiota → hunko
gripe aviar → acriko flubila
gripe española → espanna flubila
gripe porcina → porko flubila
gripe → flubila
grúa → gruva
grupo → lude, grupo
guardabosques → madrasaivaixette
guardador → gaizeoro
guardado → gaiza
guerra → gerra
guerrero de fuego → antias
guía (objeto) → redaioro
guía (persona) → redaixette
guijarro → giarra
guisante → pite
guitarra → gitarra
gula → glutonia
habilidad → estila
habitación → vitaitela
manillar → manile
hada → farura
halcón → halokun
hambre → zugra
acapella → acapela
hambruna → urzugra
hamburguesa → burgesa
hamster → peirala, milia
harina → hegoa
harpía → harpea
hechicero → xicero
hechizo, conjuro → xizo
hecho → facto
helado → freskingo ,  gelato
helecho → ferna, honko
hélice → gingilla
heliconia (flor) → gingola
Helsinki → Jelsinki
herida → daxe
hermana → meileko, herna
hermano → holeko, brodo
herradura → ayatuko
herramienta → horo
herrería → herretela
herrero → herrexette
heterosexual → heterosexualo
heterosexualidad → heterosexualita
hexágono → hexakono
hidrángea → hidranyea
hielo → gelo
hierba → herba
hierro → herro
hígado → hexinra
hijo, hija → eko
hinduismo → hinduisma
Hindú → Hindu
hipodromo → ayatela
hipopótamo → huragere, hipo
historia → historia
hogar → heiga
hoguera → ignixa
hoja → fola
Holanda → Holande
hombre → honperso
celíaco → celiaco
homenaje → homenaie
homicida → homicida
homicidio → homicidio
homosexual → homosexualo
homsexualidad → homosexualita
hongo → likena, fungo
hora → hora
horizonte → horizone
mansión → mansio
ingeniero → enginero
hormiga → nekroandaivo
hormigón → concreto
hormigueo → mitsisila
horno → forno
horóscopo → horoscope
hospedaje → huste
hostelerías → hosta
hostelero → hostexette
incubación → incube
hostia → portona
hotel → hostala
huérfano → horfano
hueso → hoso
huésped → husxette
huevo - ovo
humanidad → homoia, humanita
humano → homo
humor → zizge
humo → esmoke
huracán → hurakana
icono → icone
coño → cunno, vulve
ícor → icor
idea → idea
copo → cope
idioma, lenguaje → lango
iglesia → eklesia, praisotela
imagen, foto → imake, pikto
imaginación → imaginatio
imán → magneto
imbécil → sunkrako
ímbolo ,  signos → simo
imperio → imperia
imprenta → izkratasoro
impresión → impresio
impreso → izkrasato
impulso → busto
inaccesibilidad → inakcesibila
incertidumbre → inzertidumbre
incienso → incenso
incomodidad → inconforta
inculto → ivorte
India → Hindea
genio → genio, ginio
índigo → indigo
industria → industria
infierno → inferno
infijo → infikso
inflación → inflatio
influencia → influentia
junco → hunco
información → informa
ingeniería → engineria
ingenio → enginio
Inglaterra → Angloterra
Inglés → Anglo
inicio → initio
inocencia → inocentia
inocente → inocente
insecticida → insekticida
insecto → insekto
inserción → inserzo
instalación → instalatio
instalador → instaloro
instancia → instancea
institución → instituzio
instituto → aito-esaroriun
instrumento → instrumento
insulto → insulto
insulto → retro, insulso
intelecto → intelekto
intención → intentio
internet → interneta
intervalo → interval
intestino delgado → piko intestino
intestino grueso → oxto intestino
investigación → edarotio
investigador → edarotto
invierno → aigelaria
invitación → invitatio
ira → ruztarro
iris (flor) → iris
ironía → ironika
isla → isla
Italiano → Italeano
Italia → Italia
izquierda → zoraite
jabalí → diporko
jabón → moape, sapo, baxugo
jacinto (flor) → irsis
jade → jade
jalapeño → jalapenno
jamón → iamon
Japonés → Japonesa
Japón → Japonia
jardinero → gardaxette
jardín → garda
jarrón, florero → diarra
jazmín (flor) → terisna
jefe → jefe
jerarquía → jiderarqia
jersey → jersey
jirafa → oxpisotsa
jornada → henata, iornada
juego → joko
Jueves → traxhia
juez → juksette
jugador → jokaiette
juglar → joglar
lija → liya, afile
concepción → conceptio
jugo → xugo
Julio → Xulio
jungla → jungla
Junio → Januo
junta → junta
Júpiter → Ivpiter
juzgado → jukse
koala → koala
kosovo → kosovo
laberinto → mace
labio → labe
lado → sero
ladrillo → brico, kuxa
lago → laka
lagrima → lakrima
lámpara → litaoro
langostino → ximpo
lanza → espara
lápida → mortopetro
lapislázuli → lapislazuli
lápiz → izkrioro
texto zalgo → zalgo
lasaña → lasanna
láser → lazer
lata → canna
látigo → latikate
lavadora → xaguatoro
lavado → xaguata
lavanda (flor) → lavanda
lavavajillas → vadixaguaioro
lava → lava
lechero → esneaxette
leche → esnea
lechuga → letsuga
lectura → lekta
lejía → blanco
leñador → madrakuxette
leña → lenna
lencería → linzeria
eucalipto → arsuce
lengua → lemgo
lentes → lendait
león → leon
lerdo → tsafala
letra (canción) → lerite
letra (símbolo) → letra
ley → laia
concepto → concepto
libertad → libertia
librería → izbotela
libreta → izboiko
libro → izboto
líder → aderge, xefo
límite → limite
limpiador → likraoro
limpieza → likratia
limusina → limusina
leyenda → legenda
línea → linia
linterna → lanterna
cetáceo → cetacio
liquen → liqen
lirio (flor) → mancuma
Lisboa → Lisbona
lista → lista
literatura → literatia
litera → litera
llamada → llamata
enzima → enzima
llama → lama
llanta → xenta
llanura → planitela
llave → klave
llegada → iriheia
lluvia de balas → baletrumbe
lluvia → pluva, acoata
lobo → lauseto
locura → ankraia
lodazal → ugrarda
lodo → ugra
logro → lokro
lomo → rame
Londrés → Londonia
longitud → longoteda
loro → locuo
lucha → fista
luciérnaga → blailita
lugar → locata, itela
lujo → luxo
lujuría → luxuria
luna → luna
Lunes → lunia
luz tenue → glima
luz → lita
macarrón → makarron
maceta → mazeta
madera → madra
marcha → martsa
madero → madreno
madre (formal) → matrona
manera → modo
madre → meipai
Madrid → Madrid
madriguera → maheiga
maestría → masteria
maestro → mastero
magdalena → magadia
magia → magia
magma → magma
magnetismo → magnetisma
magnolia (flor) → magnasia
malasombra → heuntsado
mamut → mamuz
mañana (hora del día) → manza
mancha → zugra
mando (concepto) → manda
mando (objeto) → mandoro
manejo → tula
manga (ropa) → maniga
mango (de utensilios) → manega
mango (fruta) → mango
manicomio → frikostela, ankratela, frikheiga
manifiesto → manifesto
mano → man, hano
mantarraya → manraia
manta → kubre
manteca → manteca
mantequilla → mantega
manticora → mantikora
manutención → ersokio
manzana → menzana, pomo
mapache → mapatso, racune
mapa → mapa
máquina → matsina
marcador → markoro
marca → marka
marciano → marteano
marco → makora
marfíl → utso
margarita → aukuba
marica, maricón → zager
marido → honxa
marioneta → pupeto
mariposa → blaigia
mariquita → zigarra
matriz → matriks
matraz, probeta → matrace, probacupa
marisco → arraina
Martes → martia
Marte → mairte
martillo → martexo
Marzo → marzea
mar → mare
masacre → masacria
mezquita → mazquita
masa → masa
mascarada → maskerade, lufaz
máscara → lufazia, maske
mascarilla → mascarila, securitatia lufazia
mascota → heiganimal
masilla → masiya
masterización → masteratio
mastil → mastil
matadero → mataioro, mataitela, abatoro
matarratas → mortorratit
matemáticas → matematikas
matemática → matematika
material → materia
matrimonio → zimisyoixo
maullido → mauia
mayonesa → maionesa
mayoría → oxtoro
Mayo → Maio
maza → maza
moco → muco
olor → eslo
mechero → ignoro
medianoche → mitanito
media → media
mediana → mediana
medicamento → medikare
medicina → medikar
médico → medikarette
medida → metirra
medidor → metera
mediodía → mitaheno
crimen → crimen
criminal → crimenette
meditación → meditia
megáfono → megafono
mellizo → meliza
melocotón → apomo
melón → meloko
colección → colectia
menaje → furnitia, menagio
mena → vena
mención → mentio
mensaje → mesaje
menta → menta
mente → mende
mentira → musta
óvalo → oval
úlcera → ulcera
menú → menu
mercurio → mercuria
merluza → xun, mutse
meme → meme
mimo (persona) → memo
mimo (cariño) → carica, memi 
caricia → carica
mermelada → iamela
mesa → lamadra
meseta → meseta
mestizo → seutse
mes → mes
metal → metala
metro (medida) → metro
nigromante → nekromante
nigromancia → nekromantia
metro (medidor) → metroro
México → Mexiko
mezcla → mixa
micrófono → microfono
microondas → microhuaba
miedo → terro
miel →  mela
miembro (cuerpo) → membro
miembro (de un grupo) → membro
Miércoles → xeitore
mierda → merto, keska
miga → minna
milenio → aillano
milicia → milizia
militar → miliette
milla → mila
mina → mine
minería → minatia
minero → minerette
minoría → pikoloro
minuto → minute
montículo → kieva
mirador → avistela, mirator
montón → kieve. cumo
misionero → mesigette
misión → mesiga
misterio → misteria, edaro
mitad, medio → mita
medio (transporte, comunicación) → metia
mochila → esaibaga
moderador → moderaiette
modificación → modifikatio
modo → modo
moho → moldo
momento → tempeo
moneda → pinne
monitor → dorimeder
monociclo → monorroda
monóculo → monoklo
mono → monki, aco
monstruo → monstro
montaña → montanna
monte → monto
montón → plenti 
morado → purpuro
mora → blurra
mortero → morta
mosca → blainekro
Moscú → Mosku
mosquete → muskete
motivo → motivo
motocicleta → motorroda
motor → motor
motosierra → motorxerra
moto → motorroda
móvil → mobila
movimiento → mova
mueble → furno, moblo
Muerte → morto
muerto → morte
muestra → dorima
mujer → meiperso
mundo → mondo
munición → amunitio
murciélago → vesperilo, murelo
muro, pared → mura
musgo → moso
música → musika
música → musikette
nacimiento → natatia
nacionalidad → agizaia
napolitana → miniga
narciso (flor) → nersu
nariz → vono
navaja → navaia
navidad → neven
necesidad → traia
nectarina → nipomo
néctar → nektar
negación → noneatio
nenúfar → nufara
Neptuno → neptuno
neumático → kotsira
nevera, frigorífico → ingoesmar
nieta → meioeke
nieto → umoeke
nieve → aigela
niña → nenna
niños (conjunto) → kindara
niño → kindo, infante, nenno
níscalo → niscalo, mixuia
nitrogeno → nitroieno
nivel → levela
noche → nito
nogal → nuzelara
nombre → nome
norte → norto
Noruega → Norkia
Noruego → Norkeo
nota → nota
wikipedia → wikipedia
vejez → okoie
noticia → neva
notificación → nevari
novedad → nevotia
tambor → tampol
Noviembre → Novembo
novio, novia → loimike
nube seta → likenimbo
nube → nimbo
núcleo → kora
nudo → nude
nudo → nukra
Nueva york → Nevo york
nuez → nuzel
número → numo, emesimo
nutricionista → dietexette
ñú → legas
obispo → bispo
objetivo → asiga
web → web
arteria → arteria, atokla
objeto → item
pandemia → pandemos
endemia → endemos
epidemia → epidemos
oca → malira
Oceanía → ozeania
océano → oxtomare
octógono → oktokono
Octubre → Octambo
ocupación → osala
odio → rutro
oeste → oeste
ofensa → ofensa
oficina → ofizina
oficio → ofizio
ojo → exo, ogo
ola → guaira
óleo → oliuma
olla → kalerkista
olmo → elme
onda → huaba
opción → setegia
oportunidad → eiasa
orangután → ursunna, nono
orchata → esnika
ordenador → computera
orden, ordenación → ordo
orden (de orginazar) → surdo
orégano → parxa
pastilla → gobo
oreja, oido → oitio
orfanato → horfanatela
organismo → organismo
orla → aserna
ornitorrinco → tuputa
oronja → oronya
oro → aurio
orquesta → orqesta
orquídea (flor) → ortsida
ortiga → urtica, migera
oscuridad → obskuridae
ósmosis → osmosis
oso → aubaso
otoño → autonno
otra vez → retai
oveja → omejo
óxido → ragi
pacto → pacto
padre (formal) → patrono
padre → honpai
pagano → pakano
paga → paia
tío → benpai
página web → webpagena
página → pagena
país → landa, agiza, paiseko
paja (heno) → likra
heno → tseno
paja (sexo) → oarga
pájaro → payoa, caco
palabra → vorto, palabra
palabrería → vortatia
palanca → palanca
palma → palme
palmera (árbol) → irakoa
paloma → rago
palo → apika, cano, cana
panadero → britaxette
panal → panala
panda → panda
panel → panela
pansexual → pansexualo
pansexualidad → pansexualita
pantalla → visaya
pantalón → panto
pantano → saguala
pantera → pantera
pañuelo → pannola
pan → brita
pan de molde → anglobrita
papelería → pipratela
paso de zebra → rakempisa
papel → pipra
paquete (insulto) → tsusta
paquete (objeto) → paketara
paquete → paquete
parafilia → parafilia
paraguas → pluvaoro
Paraguay → Paraguai
parasol → estosol
pariente → pai
Paris → Parisa
párpado → exore
párrafo → parrafo
parrilla → grila
parroquia → parroqia
parte → parte
partida (juego) → jokaizara
partido (juego, deporte) → jokaizera
partido (político) → partero
persiana → yera, jerco
tiki → tiki

par → pare
pasado → pasato
pasamontañas → balakava
paseo → andaiata
paso → pisa
pasta (comida) → fixolo
pastel → kutsa, boglo
pastor → pastoro
pata (animal) → pezna
patata → torkopa
patio → enkampe, kampe
pato → ana
patriarca → onterrarge
patria → onterra
patron → patronna
payaso → payaso, xiabette
paz → paz
pecado → xina
pecera → pesketela
cera → equa
pecho → korata
pechuga → same
pedido → orden
pedorro → fargustarra
pedo → fargo
pepinillo → frico
pegamento → pasta
pegatina → pastenno
pegatina → pastika
peine → cailoro
pelador de patatas → torkopeler
pelador → peler
peladura → pelde
pelaje, cuero → cuoro,  peltro
fieltro → feltro
velcro → velcro
peletero → cuorette
película → filmo
peligro → perila
pella → peia
pelo, cabello → cailo
pelota, bola → bola
pelotudo → pilotufeso
peluquero → cailoxette
peñasco → pennasco
peña → penna
péndulo → pendulo
pene → penisa
pensamiento (mente) → penze
pensamientos (flor) → siakara
pentágono → pentakono
peonía (flor) → aravita
peonza → virante, rotaio
pepino → pepera
pera → pera
perca → eskada
perdón → diskaire, pardon
escuadrón → escuadra
pereza → fiagia, partsa
perezoso (animal) → fiager 
perfección → perfektio
perfil → profila
pesto → pesto
periódico → henpipra
justicia → iustika
percha → pertsa, colca, colga
periodista → henpixette
perla → perla
permiso → permiso
zombie → zombie
bobo → keke
baba → clia
perro → doerro, hundo
perseverancia → persevera
persistencia → persivita
personalización → personalizatio
personal → personale
persona → perso
pesa → pesa
pescadería → peskotela
pescadero → peskoventei
pescador → peskorette
pescado → peskoto
pesebre → bestingoro
peso → peso
pestaña (informática) → tabula
pestaña (ojo) → exogi
peste antonina → antonine pesta
peste negra → nekro morto
peste → pesta
petróleo, crudo → nekrasoa
petrolero → nekrasobarco
petunia (flor) → porpura
pez → pesko
piano → piano
picadura → estundaxe
pico (animal) → pike
pico (herramienta) → pikote
piedra → petro
piel → pelde
pierna → airpoi
pieza → pieza
pie → poi
pijama → niki
pimiento → pipera
piña → pinna, anani
pincelada → brutse
pincel → brutsa
pincho → pinko
pingüino → pingino
pino → pino
pintura (cuadro) → pintaia, pikto
pintura (objeto) → pinta
pipa → crutsa
pira (fuego) → pire
piragüa → piragua
pirámide → piramide
piraña → piranna
piscina → acoakisa
cosquilla → rakia, tiko, tikle
piso, apartamento → empartamento, bloke
pista (sobre un misterio) → hanta
pistacho → petsula, pistatso
pista de baile → danzeplane
pistola → pistola
cupón → bone
pis → pikse
pizarra (escuela) → zirraplane
pizarra (material) → ekurga
pizza → pizza
pizzería → pizzatela
placenta → ecombe
placer → pleasa
plaga de justiniano → plaga dai justiniano
plaga → plaga
planeo → planeata
planeta → planeta
planetoide → planetoido
plano → plane
planta petrolífera → nekrasoatela
planta → planta
plan → plan
plataforma → plataforma
plátano → banana
plata → silvo
platino → silverino
plato → plato
playa → plaia
pluma (animal) → felisa
pluma (boligrafo) → pluma
plutonio → plutonio
población → populatio
pobreza → poratia
poción → potia
poder → ponto
poema → poema
poesía → poesia
Polaco → Polaka
polén → polen
policía → polizia
polígono → moltoxo
olvido → huske, suparde
machacador → pestoro, morta
polla → naso
zona → zone
ozono → ozone
pollo → acriko
Polonia → Polakia
polo → pole
polo (helado) → polo
bandera aidanesa → patriska
polvo → pulder
pompa → bobal, pompe
por defecto → nurdefekto
porro → purro
portaaviones → portavionnit
portabandera → portafliaga
portabebés → portabekit
portavoz → portavoz
pórtico → portecum
Portugal → Portugal
Portugués → Portuguesa
posesivo (lengua) → posesive
pose → pose
posición → posaieo
pozo → racoia
pradera → ergiara
prado → ergia
precio, coste → kosta
precisión → prezisio
predicador → prediqette
predicado → predicado
predicción → prediktio
preferencia → sesaia
prefijo → prefikso
pregunta → kuastion, kuasta
premio → premio
prensa → prenza
preocupación → lana
preparación → preparatio
presentación → presentatio
presente → presente
presidente → presideixette
presión → preso
primavera → acoatira
primo → teoleko
prímula → acuprila
realidad → realita
princesa → princese
reinado → reina

principado → princeta
principal → printsiale
príncipe → prince
principiante → initiaxette
principio, comienzo → initio
prisa → ranta
probiótico → probiotiko
problema → problema
procedencia → proceda
procesador → procesoro
proceso → prozeso
producto → produkto
profesional → profesionale
profesión → profesio
profesor → esaroette
profeta → profeta
programación → prokramatio
programa → prokrama
progreso → progreso
promedio → promedia
promesa → priosa
pronóstico → pronostiko
propuesta, petición → petitia, precaia
prosperidad → prosperatia
prostituta → putarra
protección → protectia
proteina → proteina
proverbio → proverbio
prueba → proba
espeleología → espelologia
psicópata → psicopata
pua → pika
público → publiko
pueblo → popula
puente → ponto
puercoespín → pigotira
puerta → porta
puerto → porto
puesta de sol → solarga, solposai
puesto → posto
pulgada → pulgada
pulmón  → polmona
pulpo → pulpusa
puñal → estavoro
punto de mira, diana → nesiga
punto → punto
puré → tritura
puta → puta
quedada → quaro
quemador → ignodoxoro
quemadura → ignodaxo
queso en polvo → pulverfruge
queso → fruge
quiebra → qibra
radio (aparato) → radio
radio (elemento) → radio
ráil → riel
raíz → braine
recuerdo → rekordo, supte
rama → brianke
rana → acroa
rango → range
ranunculus → ranuncula
rata → rata
ratón (animal) → roido
ratón (ordenador) → mouse
rayo → raio
razón → reaso
reacción → reaktio
rebozuelo → mallea turfa
recepción (juegos) → receptio
recepción (lugar) → receptela
receptor → receptoro
receta → receta
recibimiento → recepta
recipiente → recipente
recogedor (objeto) → rekainoro
recogedor (persona) --< rekaixette
recogida → rekaina
récord → rekord, plusmarka
recorte → rekuta
recurso → rekurso
red local → neta locatako
red → neta
red social → sozialneta
retraso → retra
referencia → refera
reflejo → espelektia
reflexión → refleksia
regadera → rekaoro
regaliz → dultseza
regalo → regalo, presente
régimen → regimeno
región → regiono
regla → rekla
reina → reine
equipo → eqipo
reino → renno
relación → relatio
reloj de muñeca → klokonna
reloj → kloko, relox, horaviso
remasterización → remasteratio
remolacha → grosatsa
remo → esguela
reno → kirko
reparación → repaira
repetidor → repeteoro
representación → representatio
república → republika
resistencia → resistentia
resolución → resoleitio
solución → solva
respeto → respeto
respiración → rispera
saliente → evoke
balcón → evokinda
respuesta → reposta
resultado → resola
reto → testa
enrutador → enrotare
sandalía → sande
retrasado → retartato, retardato
reunión → undizio
revólver → revolver
rey → rein
rezo → praiso
riesgo → risko
rifle → rifle
rima → rima
rinoceronte → rino
río → acuokemno, riava
risa → gisa
ristra → rister
ritual → ritual
roble → acaia
robot → robot
robo → rovo
roca → roca
roce → rotse
turno → turno
rodilla → gidilla
rojo → roixo
rol → rol
romance → romanze
Roma → Roma
arrepentimiento → repentia
romero (flor) → romo
ron → rone
rosa → roixa
rotación → rotatio
rotulador → rotulaoro
rótulo → rotula
rotura → rotura
rubí → ruby
rueda → roda
maíz → juca
Rumanía → Romanea
Rumano → Romaneo
rumor → unzuna
sudor → sueta
Rusia → Ruzia
Ruso → Ruzeo
ruta → rota
Sábado → hixtane
sabana (bioma) → xabana
sábana (cama) → xiaga
sabiduría → onatia
sabor → zapor
sacacorchos → retrakorkoit
saco → sak
sacrificio → sacrifitio
sakura, cerezo → roixeral
salchicha → karnolon
saldo → saldo
salida → evokatela
salmón → tsugo
salón → asteitela
salsa → sauza
saltador → pulaioro
saltamontes → herbepulai
salto → pula
saludo → saluto
salud → vitaiko
salvapantallas → visayagaizere
sal → sale, sial
sandía → roxomelo
sangre → sigra
santo → sainto
santuario → saintotela
sapo → froga
sargento → sarjento
sartén → emfriteoro
Saturno → saturno
sauce llorón → zaprusa
secador → drioro
sección → sektion
secreto → sekreto
secta → sekta
secuencia → sequencia
seda → seda
sede → primertela
segundo → sekundo
seguridad → securitatia
seguro (algo que asegura) → secur
sello → seldo
semana → olekso
semen → bila
semilla → semila
señal → sinna
senda → kemno
esparto → esparto
señora → sira
señor → sire
sentido → senso
sentimiento → sensira
septágono → septakono
Septiembre → Septembro
sepultura → sepulta
sequía → dria
sequía → eskarratia
serpiente → serpento
serrería → madratela
servidor → sirveidoro
sesión → sesia
dromedario → dorgo
seta → tsampinna
sexo → sexo
sierra → xerra
mitómano → mitomane
mito → misto
pirómano → piromane
siglo → ozeno
significado → mea
sílaba → silaba
silencio → esparo
silla → senda
símbolo → simbolo
síndrome → sindroma
sirena (mitología) → meimare
sirena (objeto) → sirena
sistema → sistema
soberbia → superbia
sobrino → asineko
sociedad → soziata
sociópata → sociopata
socio → sozio
solar → solar
soldado, guerrero → gerraxette
sol → sol
sombra → tsado
sombreador → tsadoro
sombrero → tsadoya, horro
sonido → soniko
sonrisa → sela
sopa → faba
subida → aira
tripa → tripa
submarino → submarine
subnormal → tardo, subnormailo
norma → norme
Sudámerica → suramerika
Suecia → Suekia
Sueco → Sueko
suelo → piso
sueño → pentsio
terracota → terracota
suerte → lagenda
sufijo → sufikso
sugerencia → sugestia
suicida → suicida
suicidio → suicidio
Suiza →  Suxiza
Suizo → Suxizo
sujetador → sujeizo
sujetapapeles → sujepipra
sujetavelas → sujecandala
superavit → superavit
superficie → supratela
supervivencia → surviva
ladrón → rovette, rovago
bacon → bacon
surgimiento → sagetia
sur → sur
suspensión → reprovatio
suspenso → reprovo
sustancia → sustancea
sustantivo → nambiro
sustento ,  sostención → soteno
susurro → huxa
tabaco → tavake
tabique → privono
tabla → tablo
tablero → tablote
tacaño → takanno
taiga → taiga, karzufisi
taladro → talatro
Tallin → Taline
tallo → rute
tamaño → tamanno
tanque ,  vehiculo de guerra → basta
taparabos → sujenasoit
tarántula → tarantula
tarde → taren
tarrina → tarra
tarro → tarro
tarta → tarta
taza → ukisa
teatro → aktotela, tetero
teclado →  teklatablo
tecla → tekla
técnica → texna
técnico → texnette
tecnología → texnologia
tejado → airplane
teja → teja
tejedora (máquina) → beilaoro
tejedora (persona) → beilaxette
tejido → beila
tejón → usetse
telar → ilaoro
tela → ila
teléfono → telefono
televisión → televisoi
temática → subyectata
tema → subyecto
temblor → brusta
temperatura → tempera
tendero, vendedor → venteixette
tenedor → tinera, trintso
tenis → tenis
tensión → tentia
terminal → terminatela, terminal
termómetro → termometera
ternera → ternera
ternura → aile
terraformación → terraforma
terraplén → terrapova
terraza → terraztela
terremoto → terraxatai
agitación → xata
terreno → terranno
torno → torno
territorio → territoria
terrorista → terurasta
terror → terura
tesis → tesis
teta → burra
tetronimo → tetronimo
texto → izkrebo
té → tsa
tiburón → tsonder, esqalo
tiempo (clima) → vedo
tiempo → tempo
tienda → kompraitela
tierra infértil → hace
tierra → terra
tifón → tifona
tigre → tigra
tijera → akutoro
timbre → pistila
tímpano → timpano
tinta → tenta
joven → neve, nevon
tio, tia → teo
tipo (de tipo de cosa) → tipe
tipo (ejemplar) → klase
tipo (forma) → forma
tipo (referencia coloquial a una persona) → pal
tira → estriga
tiro → ata
titanio → titanno
titular → mantse
vasija → vasiya

transexual → transexualo
transexualidad → transexualita
título → titula
tiza → zirra
toalla → toaia
toallita → toaita
tobillo → kidna
tomate → tomako
tono → tona
tonto → erko, silki
topo → talpa, mola
tormenta → zundra
tornado → tornado
torneo → torneio
tornillo → exkrabo
toro → toro
torpedo → torpedo
torre → torra
torta → torta
entropía → entropia

tortilla → tortilla, omeleto
tortita → tortite
tortuga → tortoisa
tortura → apunda
trabajador → travaxette
trabajo → travaxo, laboro
traducción → translaio
traductor (objeto) → translaioro
whisky → wiski
traductor (persona) → translaixette
traficación → trafike
traficante → trafikaxette
tráfico → trafiko
traición → trasta
traje → gouno, esmokinno
trampa → trapa
transcripción → transcriba
tránsito → transita
transmutación → transmuta
transportador (regla) → aconvo
transporte → conve
trastorno → yiga
trenza → trence
tren → trena
triángulo → trianglo
triciclo → trirroda
tridente → tridento
trigo → trego
trinchera → trintsera
óvulo → ovulo
trismo → trisma
tristeza → tristaga
estiramiento → punxe, tritso
tristeza → tristekia
trituradora → trituoro
trompa → trompo
paseo → paizo
trompeta → trompeta
tronco → trunko
trono → trone
tropa → tropas
trucha → trutsa
truco → truka
trueno → trumbe
trufa → turfa
tsunami → tsunami, tzunami, zunami
tubérculo → tuberculo 
tubería → tubia
tubo → tube
tuerca → exkronno
tulipán → atulipa
tumba → tumba
tumor → tumor
tundra → kolfisi
tungsteno → tunsten
ventrilocuo → vintrelocuo
intruso → intrudo
turismo → turisma
turista → turista
turrón → bengela
ubicación → ubikatio, locato
vientre → vintre
Ucrania → Ukrania
último → finale
unión → unione
unión → yoixo
universidad → formatio-zentro
virgen → virgo
universo → universo
uranio → uranio
Urano → urano
uretra → uretra
Uruguay → Uruguai
uso → use
usuario → usuario
utero → utero
utilidad → utilidae
uva → uba
vaca → vaka
vacío → aucuo
vagón → bagon, wagon
vago → sugarra
vajilla → vadixa
valla → berja, fenza
valle → vale
valor (tener fuerza de voluntad) → valia
valor (valor de algo) → valua
variable → variable
Varsovia → Varsova
váscula → vascula
vaso → cupa
váter, retrete → batro, baxete, vater
vecindario → neiborotela
vecino → neiboro
vehículo → vehiklo
vela → candala
velero → sivera
velocidad → velocita
vena → sigraconve, siger
venda → ladepipra, bande
banda → banda
vendedor → ventette
Venecia → Veniza
veneno → venemo, ponzo
Venezuela → Venezola
ventana → vendexa
ventilador → vendoioro
Venus → venux
verano → solasta
verbo → verba
verdad → verdad
verdura → leguma
vergüenza → combro
verificación → verifia
versión → versiona
vestido → venaza, dreso, gouno, zitaba
vestimenta → venaza
vez → meto, vex
viaje → vixe
vía → kemno
vibrador → vibraibo
vida → vita
videojuego → vidiojoko
vídeo → vidio
viejo, anciano → igerne
viento → vendo
Viernes → vernia
VIH → VIH
villa → vila
vinagre → vinagra
vinilo → vinilo
vino → vino
violeta → violeta
violín → violinne
virginidad → virginitae
viruela → viraela
virus → virus
visado → visado
visión → viso
vista → vista
visualización → visoatio
vitamina → vitamine
viuda negra → viutonekro
viudo, a → viuto
vivienda → vivaitela
vocabulario → vokabulatio
vocal → vokal
volante (coche) → volante
volante (papel) → piprako
volcán → volkano
voz → voz
vuelo → blaia
vuelta → vira
vulva → vulve
xenón → xenon
xilófono → xelofono
yak → yak
yegüa → yequa
yunque → herrunna
zanahoria → carrota
zapatilla, zapato → poire
zoológico → zoologiko
zorro → zunio, fokso
zumo → xugino, bubo
zurdo → zoranno