abandonar → ekorei, lostigai
abanicar → cuendei
abarcar → hombai
abarrotar → furnei
abastecer → rekaroi
abatir → abaire
abollar → hundaire
abonar (echar abono) → tsesei
abonar (económico) → abonai
abordar → aborrai
abortar → abortai
abrasar → abrasai
abrazar → hogei
abrir → aiprei, apeire
abstener → abstenai
abundar → abontai
aburrir → aborrai
acampar → akempei
acariciar → caricai
acartonar → cardoi
acceder → akcisei
acelerar → acelerei
acercar → nearei
aclarar (dejar claro un concepto) → isendereim
aclarar (dejar claro un objeto) → aklaroi
acoger → akaine
acomodar → confortei
acompañar → akompannire
acondicionar → akonditiai
acordar (de acuerdo) → akordai
acordar (recordar) → akordai
activar → aktivei
actualizar → airposai
actuar → aktoai
acumular → acumai, buntsai
acusar → akusai
acuñar → acuine
adelgazar → delekai
administrar → administrei
adoptar → adoptei
adorar → adorai
adueñarse → doine
advertir → varnai
afectar → afektoi
afeitar → xavei
afilar → alfilai
afirmar → aiei
agachar → prigei
agitar → xatai
agradecer → grazei
agrandar → oxtoai
agredir → damaine
agrietar, rajar → racai
agrupar → ludai, agrupai
aguantar → jenai
agujererar → racoi
ahogar → acuarai
ajustar → rikrai
alargar → longei
alcanzar → arrai
aleatorizar → rungiai
alegrar → aibelai
alicatar → alicatai
alimentar → nisigerei, flomai
alinear → aliniai
aliviar → alivai
almacenar → esmarei
alternar → alternei
alucinar → alutinai
amaestrar → amasterai
amamantar → amamantai
amanecer → manzai
amar → loi
amargar → tsagrai
amartillar → martexei
amañar → amaine
amontonar → kievei
amputar → amputai
andar → andaire
anidar → inestai
anillar → rinkai
anochecer → nitoi
anotar → anotai
anunciar → advei
apagar → ofei
aparcar → parakai
aparecer → aparezei
aplicar → aplikai
apostar → postai
aprender → aprendei
aprobar → aprovai
apuñalar → estavai
archivo → filei
arrancar → arrantsei
arrebañar, rebañar → frotsai
arreglar, reparar → repaire
arrepentirse → repentai
arriesgar → riskai
arrodillarse → gidillai
ascender → anseine, airei
asediar → sievai, sievei
asemejarse → lokai, asemeire
asentir → asensei
asignar → asignai
aspirar → aspirai
asustar → sustai
atacar → ataktai
atardecer → tarenai
atascar → estorai, astaine
atender → atendai
aterrar → terrai, escarai
aterrorizar → terurai
atornillar → exkrabaire
atrapar → akachai
atrincherarse → laire
aullar → ululai
aumentar → easairei
avanzar → enterei
avergonzar → combroi
avisar → avistei
ayudar → ladei
añadir → adoi
añorar → annorai
babear → clire
bailar → danzeire
bajar → aurei
balanza → balantai
barajar → barajai
barrer → furrei
bañar → baxei
beber → acoi, trinkai
bendecir → bendizei
beneficiar → benefitiai, supavai
besar → besai
blanquear (dinero) → xaguai, biancai
blanquear → biancai
blindar → blindai
bloquear → lokei
bombardear → bombardai
borrar → prusai
brillar con luz tenue → glimai
brillar → briai
bromear → rusiai
burlar → bulai
buscar → findai
caber → kuai
caer → argai
cagar → mertai
calcular → kalculei
calentar → kaleire
callar → unpaire
calzarse → apoire
cambiar → kamboi
canalizar → kanalaize
cancelar → kanzelei
canjear → prizai
cansar → infizei
cantar → qanzei
captar → kaptai
capturar → kaptai
carburar → carburai
cargar → kargaize
castigar → jusai
castrar → castrai
causar → causai
cautivar → kautivai
cavar → kavaire
cazar → junzei
cenar → hingei
centellear → centelai
centrar → zentrei
centrifugar → zentrifugai
cerrar → kerrai
chatear → chatei
chispear → kispai
chocar → bumpai
chupar → likai
cifrar→ cifrei
clasificar → clasifikei
clavar → naire, klagai
cocer → kozei
cocinar → koxinei
coger → kaine
colaborar → colaborai
colapsar → colapsai
coleccionar → colectoi
colgar → colcai, colgai
colocar → kolokaire
colonizar → colonicei
colorear → kromatei, kolorei
combinar → comboi
comer → ingerai
comerciar → komerzai
cometer, perpetrar → cometai
compadecer → compadai
comparar → aslei
compartimentalizar → kompartilazei
compartir → beixize
compensar → unlanai, compensaire
completar → kompletai
componer → composai
comportarse → unbisei
comprar → kompraire
comprender → comprendai
comprobar → tseqai, testai
computar → computai
conceptuar → conceptai
condenar → condenaire
condicionar → konditiai
conducir → conduktai, drivai
conectar → conektai
confiar → diblai, trustoi
configurar → configei
confirmar → kaiei
confundir → confuzei
congelar → gelai
conocer (algo) → aonatei
conocer (persona) → misei
conquistar → conqerai
conseguir → elokrai
conservar → conservai
consolar → consoi
constar → constai
construir → tendai
contaminar → drigai
contar (con algo) → akoixei 
contar (contar a alguien algo) → rekoixei
contar (números o cosas) → kontoi
contener → containe, koi
continuar → enterai, pronkai
contraer → contraine
contratar → asignai
contribuir → contribai
controlar → controlei
convalidar → convai, convalidai
convertir → konversai
copiar → kopai
correr → zurrai
cortar → akutai
cosechar, cultivar → cropai, aznai
coser → ehelai
costar (precio) → kostei
costar (tiempo) → xitempoi
crear → createi
crecer → egrai, krekai
creer → beleize
criar → krai
crucificar → crosafikai
crujir → crustai
cruzar → crosai
cubrir → kubrai
cuidar → culdei
culpar → riaxai
cumplir → kumplaire
curar → kurai
curiosear → kuriosei
dar pereza → partsai
dar → bei
darse cuenta → indorai
dañar → daxai, injurai
deber → dutei
decepcionar → deteptionei
decidir → dezei
decir → dikerei
declarar → declaire
defender → defendei
degustar, saborear → zaporrai, degustai, degustoi
dejar → dexaire
deletrear → delektorei, espelei
demandar → demandai
depender → dependei
deprimir → deprei
depurar → purai
derivar → derivai
derramar → derramei
derribar → coarsai, derribei
desactivar → deaktivei
desagrupar → unagrupai, unludei
desaparecer → unparezei
desaprobar → deaprovai
desarrollar → deurrayai
desatornillar → desexkrabaire
desbloquear → unlokei
descalzarse → unpoire
descansar → durnei, hixei
descender → denseine, aurei
descifrar → descifrei
desconchar → descontsai
desconectar → desconektai
descorchar → unarkutsai
describir → deskriptei
desear → dezeai, pregardai
desechar → desexai, zorrai
desembarcar → desbarcai
desengrasar → torqei
desfilar → deslinai
deshacer → undoi, unfai
desinstalar → uninstalai
deslizar → eslei
desmayarse → dizkoiai
desnudar → abiarei
despedir → adei
despertar → loteire
desplazar → loamai
destacar → boldai
desterrar → desterrai
destripar (tripas) → detripai
destripar, spoilear (serie) → enteire
destronar → detronei
destruir → distroi
desvariar → desvariai
detectar → detektoi
deterger → detergire
determinar → determinai
diagnosticar → diagnostikai
dibujar → dixai
diferenciar → diferikei
diferir → diferei
digerir → dijerai
dirigir → dirijei
disciplinar → disciplaire
discriminar → discrimai
disculpar → diskaire
disfrazar → desfroi, vangai
disfrutar mucho → aioioi
disfrutar → gozoi
disipar → disipaire
disolver → disolvai
disparar → desparei
disponer → disvai
distanciar → longoai
divertir → xiaibelai
dividir → diproxei
doblar → fluksai
doler → dolei
dorar → aurai
dormir → dormei
drenar → drenai
duchar → tsoagai
dudar → dubai
duplicar → duproxei
durar → dulai
echar → etsoi
editar → editei
ejercer → ecersai
elevar → levai, airoei, quai
embalar → embalai
embarcar → embarcai
emitir → emitei
emocionar (emoción) → emozai
empalmar → apalmai 
empanar → ebritai
empapelar → empaperai
empatar → ligai, tai, tiai,
empeorar → heunei
empezar → estaire
empotrar → empotrai
empujar → pujai
encantar → enkantai
encegar → blindai
encender → onoi
encerar → equai
encerrar → enkerraire
encestar → cestai
encharcar → culdai
enchufar → plugai
encoger → nograi
encontrar → zunaire, trovai
encuestar → contestai
enfadar → rutsuei
enfadar → rutsuei
enfermar → ebilai
enfriar → aigei
engordar → lubai, fataine
engrasar → asoai
enlazar → linkei
enloquecer → lokoi, ankrai, frikoi
enmarcar → makorai
enmohecer → moldoi
enseñar → esaroi
ensordecer → sordai
ensuciar → druxai
entender → enderei, comprei
enterrar → enterrei
entrar → entrei
entregar → entregai
entrenar → traine, entraine
entronar → atronei
envejecer → igernei, okoire
envenenar → zisai, ponzai
enviar → darai
equivaler → eqivalei
escalar → escalarei
escandalizar → estantsai
esclavizar → eslavai
escocer → eskozei
escoltar → eskoltoi
esconder → jidei
escribir → izkribei
escuchar → eskotsai
escurrir → gutarei
especializar → espezialitai
espectar → espektei
esperar (esperar algo) → aikalai
esperar (tiempo) → herrei
espesar → hexegai
espíar → espai
esquivar → inzei
establecer → setei, establezei
estallar → aixai
estar de pie → estandai
estar → astei
estirar → tritsai, punxai
estresar → anorrei
estudiar → estarei
evaporar → inherbei
evitar → voitai, saire
exagerar → hurrai
examinar → examinai, testai
excitar → enusei
excusar → excusai
experimentar → experimentai, testai, testei
explicar → esplaxai, espelai
explotar → bombeire, explodei
exportar → exportei
expresar → expresei
expulsar → aztai
extender → extendaire
extinguir → extingei
extraer → tractaine
extrañar → estrannai
eyacular → gumoi
facilitar → fazilai
fallar → errai
faltar → falai
favorar → favorai
festejar → partai, faire, festai
finalizar → finalei
firmar → sennei
florecer → floirai
flotar → flotai
fluir → flogai
follar → folai, sukai
formar → formai
formular → formulai
forzar → forzai
fragmentar → fractai
fregar → mopai
frenar → freine, detrei
freír → fritei
frotar → frotsai
fumar → esmokai, inzai
fumigar → fumigai
funcionar → funzai
fundir → fusei
ganar → ganai, gonai
gastar → gastai
gemir → kemir
generar → espaunaire
girar, virar → virai
gobernar → governei
golpear → puntsai, bumpai
gozar → gozei
grabar → grabai, ikrabai, recordai
graznar → cuacai, graznai
gritar → klizei
guardar → gaize
guiar → redai
gustar → gustoi
haber → harei
hablar sin saber → farlai
hablar → paire
hacer reir → sigisai
hacer un tour → turei
hacer → doi, fai
hacerse una paja → oargai
hackear → hackei
hechizar → xizai
herir → daxei
hervir → herbei
homenajear → homenaiar
hormiguear → mitsisilai
hornear → fornai
hospedar → hustoi
huir → ezurrai
idear → ideai
imaginar → imaginei
imantar → magnetai
importar → hembei, morai
impresionar → impresei
imprimir → izkratarosotei
impulsar → bustai
incar → hincai
inclinar → inklinai
incluir → includei
incubar → incubai
influenciar → influai
informar → informei, infoi
ingeniar → enginaire
inhalar → inselei
iniciar, comenzar, empezar → initiai
inscribir → azkribei
insertar → inserei
instalar → instalai
intentar → trei
interesar → interesai
intrusear → intrudai
investigar → edaroi
invitar → invitei
ir → hei
irritar → ezirutsuei
joder → injisai
joder → xograstei
jugar (casino) → ludaine, ludai
jugar → jokai
justificar → iustikai
juzgar → juksei
ladrar → guoi
lanzar → zroi
lavar → xaguai
leer → lektei
levantar → levai, quai
liberar → liberai
licenciar → licensaire
liderar → aderei
lijar → liyare
limitar → limitei
limpiar → likrai
llamar → llamai
llegar → irihei
llenar → elloi
llevar → yeveire
llorar → lakrimai, acoatai
llover → pluvai, acoatei
lograr → lokrai
luchar → fistai
machacar → pestai, matsakai
mamar → mamaire
manchar → zugrai
mandar → mandai
manejar → turai
mantener → ersai
marcar → markai
masacrar → masacrire
masterizar → mastereize
masturbarse → mastarai
matar → mataire
maullar → mauiai
mear → piksei
mearte de miedo → pikseterroi
mediocridad → mediocrita
medir → metairre
meditar → meditei
mejorar → bainei
mencionar → mentsei
mensajear → mesajire
mentir, engañar → lerrai
merecer → dersei
mezclar → mixei
minar → mineire
mirar (mira, no sé que) → siet
mirar → avisei
misionar → mesigai
mitigar → mitigaine
moderar → moderai
modificar → modifikai
modular → modulai
montar (montar algo) → montai
montar (montar en algo) → overai
morir de hambre → estarvai
morir → mortei
mostrar flash → bliqai
mostrar → dorimei
mover → movai
multiplicar → multiproxei
mutar → mutai
nacer → natai
nadar → nataire
necesitar → trai, opaine
negar → nonei, nekai
nevar → aigelai
nombrar → nombrai
normalizar → normalai
notificar → nevai
numerar → numai
obtener → elokrai
ocultar → jidei
ocupar → osalei
ocurrir → idurei, zaine, engerei
odiar → rutrai
ofender → ofensire
ofrecer → ofrerai, gazai
oir → oi
ojalar → oixalai
ojalar → oslai
oler → eslei
olvidar → supardaire
operar → improxei
optimizar → optemizei
ordenar (de ordenar a alguien) → ordenai
ordenar (de poner orden a un lugar) → surdai
originar → origai
orquestar → orqestai
ostentar → glezai
oxidar[se] → ragiai
pactar → pactoi
pagar → paiai
parar, detener → estoi
parecer → aseire, lokai
parir → parei
parpadear → exorei
partir → partei, brokai
pasar (caminar) → paize
pasar (ocurrir) → zaine
pasear → paize
pastar → pastaixe
pasteurizar → pausterai
patear → poitsire
pausar → pauxai
pecar → xinai
pedir → precai
pegar → pastai
pelar → pelai
pelear → faitai
peligrar → perilai
pender → pendei
pensar → penzei
perder → pardaire
perdonar → pardonai
perecer → peretai
perfeccionar → perfektei
perforar → perzroi
permanecer → unfinai
permitir → permisai
perseguir → prosecai
perseverar → perseverai
persistir → persiverai
personalizar → personalizei
pesar → pesai
pescar → peskei
pestañear → exorei
picar (bicho) → estungai
picar (minar) → 
pincelar → brutsei
pinchar → pinkai
pintar → pintei
pisar → pisoi
planear (plan) → planoi
planear (volar) → planeai
plantar → plantaire
poder → pontai
poner → posai
posar → posei
poseer → posesai
posibilitar → posiblai, posibilai, posibilitai
posponer → posposai
practicar → praktikai
precisar → prezisei
predecir, predicar → predikei
predicar → predicai
preferir → sesai
preguntar → kuastionei
premiar → premire
prender → fokai
preocupar → lanai
preparar → preparei
presentar → presentei
presidir → presidei
presionar → presoi
presumir → priuzei
prever → prevai
previsualizar → previsoi
probar (de manera científica) →  prostei
probar → probai
procastinar → procastinai
proceder → procedei
procesar → procesai
procrastinar → procrastinei
producir → proteire
programar → prokramai, codai
progresar → progresei
prolongar → prolongaire
prometer → priosai
promover → promovai
pronosticar → pronostikaire
proponer → petiai
prosperar → prosperai
proteger → protectai
publicar → publikai
quebrar → qibrai
quedar sin → ranaire
quedar → quaroi
quemar → tsizirrei, ignodaxai
querer → qarei
quitar → removai
racionar → rationai
rascar → kikroi
rayar → raiaire
razonar → reasoi
reaccionar → reactai, reaktai
realizar → ereasei
recaudar → rekauroi
receptar → receptei
recetar → recetei
rechazar → retsaire
recibir → receptei, recebai
recluir → reklui
recoger → rekaine
recomensar → reguardai
reconocer → kognai
recordar → rekordai
recorrer → enzurrai
referenciar → referai
reflejar → espelektei
reflexionar → refleksei
refrescar → refreskei
regalar → regalei
regar → rekai
regresar → retornai
rehacer → redoi, refai
reir → gisai
relucir húmedo → acolaine
relucir → enlitai
remar → esguelai
remarcar → remarkei
remasterizar → remastereize
remover → removai
remunerar → remonetai
rendirse → purnai
renovar → renevoi, renevai
repetir → repetei
replicar → reproxei
reportar → reportei
representar → representei
reproducir (vida) → prokraire
reproducir (vídeo) → dorimei
reptar → aurandaire, okroi
resistir → resistai
resolver →  resolei
respetar → respektei
respirar → risperei
responder, contestar → repostai
restablecer → resetei
restar → deproxei
retener → rentiei
retirar → retroi
retrasar → retrai
reunir → undizei
revivir → revivai
revocar → revokei
rezar → praisoi
rimar → rimai
robar → rovai
rodar → rodai
romper → rompeire
rondar → rondai
rotar → rotai
rotular → rotulei
rozar → rotsai
rumorear → unzunai
rutilar → gliai
saber → onetai
sacar → retrai
saciar → satiarei
sacrificar → sacrifai
salir → evokai
saltar → pulai
saludar → haiai
salvar → saivai
sanar → sanai
sancionar → sanziarei
sangrar → sigrai
secar → driai
sedar → sedai
seguir → sigai
seleccionar → selektei
sentar → sendai
sentir → sensei
sepultar → sepultai
ser → sei
servir (servicio) → servei
servir (uso de algo) → sirvei
señalizar → sinnai
significar → mearei, daine
silenciar → esparei
sitiar → sitei
sobrevivir → survivai
socializar → sozialei
soltar → soltai
solver → solvai
sombrear → tsadoi
sonar → audei
sonreir → selai
sostener → sotenai, sotaine
soñar → pentsizei
subir → airei
suceder (continuar) → enterai
suceder (suceso) → berai
sudar → suetai
sugerir → sugestei
sujetar → sujei
suliveyar, encantar → aloi
sumar → suproxei
superar → raize
supervisar → supervisoi
suplicar → supraxai
surgir → sagei
suscribir → suscribai
suspender → reprovai
susurrar → huxai
talar → tsopar, tambar
tamizar → tamizei
tapar → supai
tardar → egentai
tejer → beilai
teletransportar → teleportai
temblar → gaxei
tender → ibsoi
tener → taine
tensar → tentai
tentar → soblasnei, movai
terminar → teirnai
terraformar → terraformei
teñir → tentai
tirar → atai
tocar → toutsoi
tomar → tomei
torturar → apunderai
trabajar → travaxei
traducir → translai
traer → brogei
traficar → trafikai
traicionar → trastai
trampear → trapai
transcribir → transcribei
transitar → transitei
transmutar → transmutai
transportar → aconvoi
transportar, desplazar → deksplozai
trastornar → yigai
tratar → traire, tiskai
triplicar → triproxei
triturar → trituroi
tronar → trumbai
truncar → truncai
turnar → turnoi
unir → yoi
usar → usei
valer → valei
validar → validai
valorar → valuai
variar → varei
vendar → bandei
vender → ventei
vengarse → revengai
venir → narei
ver, visualizar → visoi
verificar → verifei
verter → verdai
vestir → vanaize
vetar → paine, banai
viajar → vixei
vibrar → vibrai
visitar → visitei
vislumbrar → zovisai, zintaire
vivir → vivai
volar → blai
volver → barei
vomitar, potar → resoltai, pukai, pukaire