a la derecha, hacia la derecha → aldereite
a la izquierda, hacia la izquierda → alzoraite
a la → ala
a punto de terminar → afinale
a veces → em tempeoit
a → a
aacumular → acumai, buntsai
abadía → abia
abajo → aur
abalconado → evokinde
abandonado → ekoreko
abandonar → ekorei, lostigai
abandono → ekoretio
abanicar → cuendei
abanico → abaniko, cuenda
abaratar → atsai
abarca → abarka
abarcar → hombai
abarrotar → furnei
abastecedor → rekarette
abastecer → rekaroi
abastecimiento → rekaratio
abastecimiento → rekarotio
abatir → abaire
abdomen → abdomo
abdominal → abdomonexo
abecedario → letratablo
abedul → atria
abeja → blaimallea
aberración → aberratio
abertura → aipreixo
abeto → karzua
abiertamente → aipreiroso
abierto → apero, aipreoso
abisal → abysal
abismal → oxtuoro
abismo → abystela
abogado, legista → abvogette
abollado → hundiko
abolladura, abollón → hundo
abollar → hundaire
abominable → abomeineko
abonado (dinero) → abonako
abonado (tierra) → tsesako
abonado → abonoko
abonar (echar abono) → tsesei
abonar (económico) → abonai
abono (abonar dinero) → abono
abono (tierra) → tseso
abordado → aborrako
abordaje → aborratio
abordar → aborrai
abortado → abortado
abortar → abortai
aborto → aborto
abracadabra → magika ragika
abrasar → abrasai
abrasivo → abrasivo
abrazado → hogoko
abrazar → hogei
abrazo → hogo
abrebotellas → aiprebotelo
abril → aiprila
abrir → aiprei, apeire
absoluto → absoluto
abstención → abstena
abstener → abstenai
abstenido → absteno
abuela → meioko
abuelastra → inestmeioko
abuelastro → inestumoko
abuelo → umoko
abundancia → abontia
abundante → abonte
abundar → abontai
aburrido → aborrado
aburrimiento → aborraitio
aburrir → aborrai
acacia → akacea
academia → akademia, academos
académico → akademiko
acampada → akempa
acampar → akempei
acapella → acapela
acariciar → caricai
acartonar → cardoi
acaso → nurne
acaso → nurne
acceder → akcisei
accesibilidad → akcesibila
accesible → akcesibla
acceso → akciso
acción rápida → rante aktio
acción → aktio
aceite → asoa
aceitera → asonexo
aceitoso → asoaso
aceleración → acelereitio
acelerador → aceleoro
acelerar → acelerei
acera, pavimento → vadeo, kalekemno
acercar → nearei
acero → akero, azero, acero
aclarar (dejar claro un concepto) → isendereim
aclarar (dejar claro un objeto) → aklaroi
acoger → akaine
acogida → akaina
acomodar → confortei
acompañado → exekoro
acompañamiento → akompanniretio
acompañar → akompannire
acondicionar → akonditiai
acondición → akonditia
acordar (de acuerdo) → akordai
acordar (recordar) → akordai
acordeón → acordeon
acrobacia → akrobatia
acróbata → akroxette
activación → aktivatio
activar → aktivei
actividad → aktivita
acto → akto
actor → actor
actriz → actoras
actuación → aktoatio
actual → airpose
actualización → airposo
actualizado → airposaioko
actualizar → airposai
actuar → aktoai
acuario → acoario
acuerdo → akordo
acumulación → acumo, acuma, acumula, acumulo, cumul, cumulo
acusado → akusako
acusar → akusai
acusativo → akusative
acuático → acoatiko
acuñar → acuine
adelante → daotan (otan)
adelgazar → delekai
además → ademais
además → ademais
además → ademais
adicción → adiktia
adición → ado
adictivo → adiktoso
adicto → adikto
adiós → adem
administrador → administreiette
administrar → administrei
adobe → adobe
adonis (flor) → adonis
adoptado → adoptocorrecto
adoptar → adoptei
adoración → adoro
adorar → adorai
aduana → otertseqe
adueñarse → doine
adverbio → adverba
advertencia → varno
advertir → varnai
aeropuerto → aerporto
aeróbic → aerobika
afección → afektio
afectar → afektoi
afecto → afekto
afeitadora → xaveioro
afeitamiento → xava
afeitar → xavei
afganistán → afganistan
afgano → afgano
aficionado → afizionette, abanere
afición → afizio, aban
afijo → afixe
afilación → alfilatio
afilado → alfilago
afilar → alfilai
afirmación → aiatio
afirmar → aiei
afortunado → helera
agachar → prigei
agache → prige
agencia → agentia
agitación → xata
agitar → xatai
agonía → agonia
agosto → agaisto
agradecer → grazei
agradecimiento → grazeizero
agrandar → oxtoai
agredir → damaine
agresivo → agresibo
agricultor → agrikulxette
agricultura → agrikultura
agrietar, rajar → racai
agrio → xigro
agrupación → agrupatio
agrupar → ludai, agrupai
agua → acoa
aguacate → guacafruki, aguaco
aguantar → jenai
aguante → jena
aguijón → estungo
agujererar → racoi
agujero de bala → racobale
agujero → raco
ahogar → acuarai
ahora → nau
ahí → aye, alan
aidanacia → aidanakia
aidanés → aidanesa
aire acondicionado → aerakonditiaoro
aire → aer
ajo → garlo
ajustar → rikrai
ajuste → rikro
al lado de → ensero
al → aei
alargar → longei
alarma → alarme
albania → albanea
albanés → albanexe
albinismo → albinisma
albino → albino
albino → albino
alcanzar → arrai
alce → bazerra
alcohol → etanol, altsol
aldea → aldea
aldeano → aldeano
aleatoriedad → rungia
aleatorio → rungo
aleatorizar → rungiai
alegrar → aibelai
alegría → aibe
alemania → duxlan
alemán → duxleano
alfajor → almodratso
alfombra → corta
algo → akoixa
alguien → aperso
alguna forma → aforma
alguno → aione
algún lugar → atela, alocato
algún momento, alguna vez → atempo
alimentación → flomo, nisigo
alimentar → nisigerei, flomai
alimento → flomiga, nisingo
alineación → aliniatio
alineado → aliniato
alinear → aliniai
aliviar → alivai
allí → alie, alan
alma → anima
almacenaje → esmariun
almacenamiento → esmaretio
almacenar → esmarei
almacén → esmareitela
almeja → matsasa
almena → almena
almendra → almondra
almidón → amilone
almohada → bexe
alquitrán → betarra
alrededor → eriodo
altar → altar
altavoz, parlante → sonikemitero
alternar → alternei
alternativa → alternas
alternativo → anternaiko
alterno → alternaso
alto → aito
altruista → altruista
altura → aitora
alucinación → alutination
alucinar → alutinai
amaestrar → amasterai
amamantar → amamantai
amanecer → amanza
amanecer → manzai
amanecer → solnata
amanita → amanita
amante → loiere
amapola → maploa
amar → loi
amaranto (flor) → amaranto
amargado → tsagrioso
amargado → tsagrioso
amargar → tsagrai
amargo → tsagrio
amarillo → mallea
amartillar → martexei
amatista → amatista
amañar → amaine
ametralladora → metrallaro
amigo con derecho → rotsenko
amigo, amiga → amike, amiko, amika
amistad → amikia
amistoso → amikeso
amontonar → kievei
amor patriótico → onterraloi
amor → loi
amplio → amplero
amputación → amputatio
amputación → unmembria
amputar → amputai
américa → amerika
anarquía → anarqia
andador → andaivo
andar → andaire
andesita → andesita
andorra → andorra
andorrano → andorreo
androide → androido
andén → vaden
angila → gistomo
angola → angola
angolano → angolaneo
anguila → zegor, zangela
anidado → ineste
anidar → inestai
anillar → rinkai
anillo → rinka
animal → animal, besta
aniversario → yaroia
anoche → anito.
anochecer → nitoi
anochecer → nitoia
anomalía → anomalia
anotar → anotai
ante → ante
anteanoche → pre→anito.
anterior → aldonko, prevo
antes de ayer → pre→aldehen.
antes → alde
antibiótico → antibiotiko
antifaz → antifaz
antigua y barbuda → antigua e barbuda
antiguano → antiguaneo
antiguedad → antiaga
antiguo → antio
antipático → antimaiso
antorcha → tortsa
antártida → antartika
anual → yaroko
anuario → yarizboto
anunciar → advei
anuncio → adva
anárquico → anarqiko
anémona (flor) → anomas
apagado → off
apagamiento → ofetio
apagar → ofei
apagón → deof
aparcar → parakai
aparecer → aparezei
aparición → aparezeitio
apeadero → apeadela
apellido → aurnome, ginome
apenas → apare
apertura → aipreio
apicultor → apikulxette
apicultura → apikultura
aplicación → aplikatio
aplicar → aplikai
apodo → xenome
apostar → postai
aprender → aprendei
aprendizaje → aprendeixo
aprobación → aprovatio
aprobado → aprovo
aprobar → aprovai
apuñalada → estava
apuñalamiento → estavo
apuñalar → estavai
aquí → ake, atan
arabia saudita → arabika saudita
araña → vesuka
arboleda → arbotsiun
arbusto rodante → erbusto da deserto
arbusto → erbusto
arcano → arcana
arce → gizalda
archipiélago → artsipelago
archivo → file
archivo → filei
arcilla → clugra
arco → arketo
arcoiris → kolorarico
ardiente → igneoso
ardilla → esquiro, bunyo
area → area
arena → auxa
arenas movedizas → auxarran
argelia → argelia
argelino → argelineo
argentina → argentia
argentino → argento
arma → arma
arma → armatia
armadillo → puntsirra, armado
armadura → armatsosto
armar de valor, echarle huevos → retrai nai valia
armario → orraqe
armenia → armenia
armenio → armeno
arqueologo → arqeologe
arqueología → arqeologia
arrancar → arrantsei
arranque → arrantsa
arrebañar, rebañar → frotsai
arreglar, reparar → repaire
arreglo → reparo
arrepentimiento → repentia
arrepentirse → repentai
arriba → air
arriesgar → riskai
arrodillarse → gidillai
arte → arte
artefacto → artefactum, artefacto
arteria → arteria, atokla
artículo → articulo, articlo
arándano → aniluba
ascender → anseine, airei
ascenso → ansenno
ascensor → airoro
asentir → asensei
asia → asia
asiento → asenda
asignar → asignai
asno → ostoro
aspecto → aspectia
aspiración → aspira
aspiradora → aspiraoro
aspirar → aspirai
aspirina → anfluga
astato → astato
astilla → artsa
astro → astro
astronauta → astronatte
asunto → reaso
asustar → sustai
así de → aze da
así → aze
atacar → ataktai
ataque al corazón → koraisagra
ataque → atakte, atake
atardecer → tarena
atardecer → tarenai
atascar → estorai, astaine
atención → atentio
atender → atendai
aterrar → terrai, escarai
aterrorizar → terurai
atornillar → exkrabaire
atrapar → akachai
atril → lekteoro
atrincherarse → laire
atrio → atrio
atrás → betran
atún → tunna
audio → audeo
audífono → audefono
aullar → ululai
aullido → ulule
aumentar → easairei
aumento → easa
aunque → ounqe, ounqa
aura → auram
auricular → oitosono
aurora → aurora
autismo → autisma
autobús → autobus
autor → autora
avance → entero
avanzar → enterei
avaricia → avaritia
avaricioso → avarito
avenida → avenua
aventura → ventura
avergonzado → combrako
avergonzar → combroi
avestruz → otsorra
avisado → avistoko
avisar → avistei
aviso → avisto
avión → avionno
ayer → aldehen
ayuda → lade
ayudar → ladei
azafrán (flor) → aziala
azahar (flor) → azaharo
azar → runge
azul celeste → acoa
azul → anil
azulejo → eskala
azúcar → sukra, sucra
añadir → adoi
añalejo → relicrolista
año → yaro, anio
añorar → annorai
aún → oun.
baba → clia
babear → clire
bacon → bacon
badén → batino
bahía → baheia
bailar → danzeire
baile → danze
bajada → aura
bajar → aurei
bajo → pikoso
bajo → vao
bala → bale
balanza → balantai
balanza → balante
balcón → evokinda
ballena → argeya, baola
baloncesto → bolacesta
bambú → bambo
banco (edificio) → banko
banco (sentarse) → sendaia
banda → banda
bandeja → indaksa
bandera aidanesa → patriska
bandera → fliaga
banquero → bankexette
banquete → banqete
baraja → baraja
barajar → barajai
barato → atsoso
barcelona → barcelona
barco → barco
barra → cana, baferro
barrendero → furrette
barrer → furrei
barrera → barrera
barricada → barraca
barrido → furre
barril → barrila, tondra
barrote → furne
base → base
bastante → bixa
bastantes → bixa
bastilla → bastila
bastión → baluaro, bastiraa
bastón → baton
basura → grax
batalla → bataila
batido → socrema
batido → socremeko
bauxita → bauksit
baya → eruba
bazar → bazar, baziar
bazooka → bazuka
bañar → baxei
bañera → bax
baño (lugar) → mertaitela
baño (referencia a objeto) → mertaioro
beber → acoi, trinkai
bebida → acoixo
bebé → beko
begonia (flor) → begonna
belleza → belesa
bello → belo
bendecir → bendizei
bendición → bendizatio
beneficiar → benefitiai, supavai
beneficio → benefitio
beneficioso → benefitioso
bengala → bengala
benigno → bainxo
berenjena → isaloa
berlin → berline
berlina → berlina
besar → besai
beso → beso
bestia → besta
biblioteca → bibloteka
bicho → tiko
bicicleta → birroda
bien → bain
bienvenido → bainarei
bienvenido → bainaro
billón → billoe
bioma → bioma
bisabuela → bismeioko
bisabuelo → bisumoko
bisagra → izoya
bisexual → bisexualo
bisexualidad → bisexualita
bismuto → bismuto
bisonte → bisonte
blanco → bianco
blando → bloneto
blanquear (dinero) → xaguai, biancai
blanquear → biancai
blindar → blindai
bloque → bloke
bloqueado → lokeioto
bloquear → lokei
bloqueo → lokeo
boa → zisga
bobo → keke
boca → oupa
bocadillo → britango
bola de nieve → aigebola
boleto → fixola
boletus → boletus, mastufa
bollería → bunaria
bollo → bollo
bollo → bun
bolsa → baga
bolsillo → pokete
bolígrafo → tentaoro
bomba → bomba
bombardear → bombardai
bombardero → bombardoro
bombero → ignoextingette
bombilla → bulba
bombona → butanna
bombón → tsoklo
bonito → piloko
boquilla → oupila
borde → asero
borracho → trunko
borrador (boceto) → druxeto
borrador (herramienta) → prusaioro
borrar → prusai
borroso → fizo
bosque → fisi, arbotsiun
bota → bota
bote → bote
botella → botelo
botón → botonna
branquia → brankia
brasil → brazil
brasileño → brazilenno
brazalete → airoie
brazo → airo
bricolaje → bricolagia
brillante → brixante
brillar con luz tenue → glimai
brillar → briai
brillo → brio
brisa → briza
brizna → hebra
broche → brutsio
broma → rusa
bromear → rusiai
bromelia (flor) → estarola
bromo → bromo
bronce → bronce
brusco → zizenno
brío, garbo → farla
bucal → oupare
bucarest → bukaresti
budismo → budisma
buen → baine
buenas noches → baine nitoit
buenas tardes → baine tarenit
bueno → baine
buenos días → baine henit
buenos días → baine manzait (por la mañana, no se usa)
buey → zarra
bufanda → bunfaza
bufón → bulanere, xiabette
buitre → xikorra
buque → buqe, dunko
burgo → burge
burla → bula, vanka
burlar → bulai
burrito → burrito, kubrutso
burro → zigar
buscador (cosa) → findaoro
buscador (persona) → findette
buscar → findai
busto → perpetro
butaca → cansenda
butano → butano
bárbaro → barbaro
bégimo → behemuto, bemoz
bélgica → belgia
bélico → beliko
búfalo → bufalo
búho → ebande
búsqueda → findo
caballero (hombre) → vero
caballero (que monta a caballo) → ayette
caballito de mar → marayato
caballo → ayato
cabe → kabe
caber → kuai
cabeza → antsasa. casca
cabezón, terco (insulto) → bluta
cabina → cabin
cable → guiro, tokla
cabra → koato
cabrón → fuzo
cabrón → morogo
caca → nnordo, fecta
cacahuete, cacahuate → cacauato
cacerola → kaserola
cacería → junziasa
cactus → cactia
cada → etse
cada → kada
caer → argai
café → kafe
cagada → mertato
cagar → mertai
caida → arga
caja de herramientas → horocuba
caja fuerte → herrocuba
caja → cuba
cala (flor) → belania
calabazín → cumba
calamar → kalatrono
calamidad → calamitas
calavera → antsoarko
calcetín → poitexo
calculadora → kalculoro
calcular → kalculei
calefacción, calefactor → kaleria
calendario → henlista
calentamiento → kaleirisa
calentar → kaleire
caliente → kalerkoso
callado → unpaireoso
callar → unpaire
calle (referencia general) → estrato
calle → kale
callejero → estratoge
calor → kaler
calvo → calvo
calzarse → apoire
calzoncillo → carkazono
caléndula → calendula
cama → dormebas
camaleón → jideor
camarero → hostexette
cambiar → kamboi
cambio → kambio
camello → usatsa, camolo
camino → kemno, rata
camisa → kamisa
camiseta → kamiseta
camisón → camiso
camión → oxtokotse, lorro
campamento → akempo
campanero → campelette
campeonato → tsampeonato
campesino → campesette
campeón → tsampeon
campo → kempo
canadá → canadia
canadá → kanada
canal → kanala
canalizar → kanalaize
cancelación → kanzelatio
cancelar → kanzelei
cancha → kempo, jokotela
canción → qanzio
candelabro → candalabro
cangrejo → kraba
canguro → kangoro
canjear → prizai
canoa → canoia
cansado → infizo
cansancio → infize
cansar → infizei
cantar → qanzei
cantautor → qanzautora
cantera → petrotela
cantero → petroxette
cantico → qanzigo
cantimplora → acoino, cantimpla
cantina → cantena, ingotela
canto → qanzo
caoba → untsuaç
capa → elara
capaz → abil
capilla → capela
capital (ciudad) → enciuta
capital (dinero) → capital
capitalismo → capitalisma
capitalista → capitalista
capitán → captanna
captar → kaptai
captura → kapta
capturar → kaptai
capullo (mariposa) → cucula
capullo → fasoa
cara → fazia
caracol → itsa, cargo
carbon → karbona, cocola
carburante → carburanto
carburar → carburai
carburo → carburo
carcaj → qiava
carcelero → cartselette, caugo
cardo → tsardo
carga → karga
cargador → kargaoro
cargar → kargaize
caricia → carica
carisma → tsarisma
carismático → tsarismatiko
caritativo → karitatoso
cariño (referencia a persona amada) → karico
carnaval → carnavala
carne → karno
carnicero → karnirette
carnoso → karnoso
caro → karo
carpeta → folda
carpintero → madraxette
carrera (juego) → zurraion
carrera (universidad) → cursogra
carretera → rakemno
carruaje → azurreje
carta (texto) → letera
cartero → leteraette
cartilla → cartila
cartón → cardo
casa → kasa
cascada → moana
casco → antsal
caseta, cabaña → asunna, kasutsa
casi → axi
casilla → kasiya
casino → casino
casta → casta
castaña → nizaga
castaño → nizagal
castigado → jusaioto
castigar → jusai
castigo → jusa
castillo → castil
castor → biatse
castrar → castrai
catalejo → foreviso, forevo
catarsis → katarsis
catastrofe → combe
catorce → dizicatro
cauce → calikso
causa → causa
causar → causai
cautivar → kautivai
cautividad → kautivita
cautivo → kautivita
cavar → kavaire
caviar → haviar
caza → junze
cazador → junzette
cazar → junzei
cazo → xikara
cazuela → xikere
caña → kanna
cebolla → onnete
cebra → zebra
cedro → citrua
celda → celar
celíaco → celiaco
cementerio → mortotela
cena → hinge, yantaro
cenar → hingei
cencerro → beletro
cencerro, campana → campela
ceniza → axa, inzo
centaurea (flor) → centara
centella → centela
centellear → centelai
centenario → ozenore
centenario → ozenoso
centeno → surtso
centrar → zentrei
centrifugadora → zentrifugaioro
centrifugar → zentrifugai
centro → zentro
cepillo de dientes → dentabrutsa
cepillo → sebrutsa
cera → equa
cerca → neare
cerda (pelo) → furro
cerdo → porko, pigo
cerebro → mentio
cereza → roxuba
cero → zuro
cero → zuro
cerrado → kerraiso
cerradura → klavika
cerrajero → klavikette
cerrar sesión → evokai sesai
cerrar → kerrai
cerrojo → kerranda
cerveza → birraza
cesta → cesta
cetáceo → cetacio
chaleco → tselo
chamarra → burtso
chaqueta → giaqeta
charco → culda
chat → chat
chatear → chatei
chelo → tselo
chica con derecho → rotsenmeia
chica → meia
chico con derecho → rotsenhone
chico → hone
chile → tsile
chimenea → tsimeneia
chimpancé → itsimp
china → tsina
chincheta → pinna
chinchilla → tsintsila
chino → tsineo
chip → chip
chispa → kispa
chispear → kispai
chiste → zizga
chistera (sombrero de copa) → tsistera
chocar → bumpai
chocolate → xouclate
chuche, caramelo → dultsina
chupada → lika
chupar → likai
ciclismo → ciklisma
ciclo → ciklo
ciego → blinda
cielo (religión) → estelegas
cielo → kailo
cien → ozen
cien → ozen
ciencia → cientsa
cienciología → cientsologia
científico → cientsette
cierto (especificando algo) → certo
cierto → zerto
ciervo → perlo
cifra → cifra
cifrado → cifrato
cifrar→ cifrei
cigarro, cigarrillo → zigarro, cigarro, inzono
cilindro → cilindro
cima → zima
cimitarra → escimitarra
cinco → qinco
cinco → qinco
cincuenta → qincoen
cinta transportadora → aconveioro
circunstancia → zirkuntantia
ciruela → pluma
cisne → aista
cisterna → cesterna
ciudad → ciuta, ciutatela
claridad → klaritatio
claro (refiriendote a algo que es claro) → klaro (ejemplo: ¡claro que si me importan!)
claro → klaro
claro → klaro
clase → klase
clasificación → clasifike
clasificar → clasifikei
clavar → naire, klagai
clave → klave
clavel → maira
clavija → klaviya
clavo → klaga
clemátide (flor) → espirita
cliente → komprairette
clima → climaia
cloro → cloro
cloroformo → cloroforme
clásico → eclasiko
coartada → quartada
cobre → ikroso
cocaína → cocaina
cocaína → kokaine
cocer → kozei
coche, carro, auto, automóvil → kotse, vehiklo, automovo, zurro
cocido → kozido
cocido → kozido
cocina (lugar de cocinar) → koxineitela
cocina (termino general) → koxina
cocinado → koxineioto
cocinar → koxinei
cocinero → koxinette
cocodrilo → crocus
cofre, baúl → gaizecuba
coger → kaine
cogida → kaina
cojín → zobexe
col → colta
cola (animal) → urda
cola (personas) → qeola
colaborar → colaborai
colapsar → colapsai
colapso → colapso
coleccionar → colectoi
colección → colectia
colegio, escuela → esaroriun, eskola
colgar → colcai, colgai
colibrí → liarta
colina → yordea, sugal
colindante → colinte
colmena → bajiba
colocación → kolokatio
colocar → kolokaire
colombia → kolombia
colonia (territorio) → colonia
colonia, perfume → dafuma
colonización → colonicea
colonizado → coloniko
colonizar → colonicei
colono → colone
color → kolor, kromato
colorear → kromatei, kolorei
coma (salud) → coma
coma (texto) → coma
comando → comando
comba → pulanda
combinación → combo
combinar → comboi
comburente → comburente
combustible → nitor, combustable
combustión → combustio
combusto → combusto
comedor → ingotela
comer (coloquial) → ingoi
comer → ingerai
comercial → komerziale
comerciar → komerzai
comercio → komerzio
cometer, perpetrar → cometai
comida → ingo
como (comparación) → asle
como (pregunta) → com, come
comodidad → conforta
compadecer → compadai
comparación → asletio
comparar → aslei
compartimentalización → kompartilazetio
compartimentalizar → kompartilazei
compartir → beixize
compasión → compasion
compatible → kompatible
compañero de clase → klasenko
compañero de cuarto → itelenko
compañero de cárcel → cartselenko
compañero de piso → blokenko
compañero → kompannette, enko
compañía → kompania
compendio → compentio
compensación → unlana, compenso
compensar → unlanai, compensaire
complejo (instalaciones) → komplexo
complejo → complekso
complemento → komplimento
completar → kompletai
completo → kompleto
complexión → komplexio
componer → composai
comportamiento → unba
comportarse → unbisei
compra → kompra
comprador → kompraixette
comprar → kompraire
comprender → comprendai
comprensión → comprendo
comprobación → tseqe
comprobar → tseqai, testai
comunidad → comunitatia
comunismo → comunisma
comunista → comunista
comunista → comunista
común → komuna
con → koi
concepción → conceptio
concepto → concepto
conceptuar → conceptai
concha → akontse
condado → contia
conde → condo
condena → condena
condenado → condeno
condenar → condenaire
condicionar → konditiai
condición → konditia
conducir → conduktai, drivai
conducto → driveno, condukto
conductor (objeto) → conduktoro
conductor (vehículo) → drivette, conduktette
condón → kundonna
conectado → conekto
conectar → conektai
conejo → isgaro, buno
conexión → conektio
confianza → dibla
confiar → diblai, trustoi
configuración → configo
configurar → configei
confirmar → kaiei
confundido → afuska
confundir → confuzei
confusión → confuzio
congelado → gelatio
congelador → gelaioro
congelar → gelai
conocer (algo) → aonatei
conocer (persona) → misei
conocido → miseioko
conocimiento → aonatia
conquista → conqitia, conqista
conquistado → conqisto
conquistador → conqeror
conquistar → conqerai
conseguir → elokrai
conservación → conservatio
conservador → conservette
conservar → conservai
consolar → consoi
consorcio → consortso
consorte, cónyuge → conyuge
constante → constanto
constar → constai
constelación → constelatio
construcción → tenda
constructor, arquitecto → tendaxette
construir → tendai
contaminación → drigatio
contaminar → drigai
contar (con algo) → akoixei
contar (contar a alguien algo) → rekoixei
contar (números o cosas) → kontoi
contención → containio
contener → containe, koi
contenido → contento
contexto → conteksto
continuar → enterai, pronkai
contra → kuntroi, ainsta
contraer → contraine
contraseña → codivorto
contratar → asignai
contribución → contribe
contribuir → contribai
control → control
controlar → controlei
convalidar → convai, convalidai
conversación → pairetio
conversión → konversio
convertido → konversaioko
convertir → konversai
copa → cope
copenague → kopenage
copia → kopea
copiar → kopai
copo → cope
coque → coke
coral → arima
coraza → koraza
corazón → koraiso
corbata → corveta
corcho (material) → arkutsa, korko
corcho (panel de corcho) → arkutsaplane
corcho (tapón de botella) → arkutsa
cordón → cordo
cornudo → cornato
corona → korona
corpa → corpe
correcto → korrektoko
corredor → zurrette
correo electrónico → elektrikono maila
correo → maila
correr → zurrai
corrida (cualquier significado no sexual) → zurrata
corrupción → korruptio
cortar → akutai
corte → kuta
corto → coto
cosa → koixa
cosecha → cropo
cosechar → cropai
coser → ehelai
cosquilla → rakia, tiko, tikle
costa → koasta
costar (precio) → kostei
costar (tiempo) → xitempoi
costilla → crustela
costra → ruxga
costura → ehelo
coyote → cuxate
coño → cunno, vulve
creación → creata
crear → createi
crecer → egrai, krekai
crecimiento → egra
creencia → belei
creer → beleize
crema → crema
crematorio → tsizirreitela
crepúsculo → horcasto
cretino → filastra
cria → kraia
criada → kraiette
criar → krai
crimen → crimen
criminal → crimenette
crisantemo → crisantemo
crisol → crucibla
cristal (mineral) → kristal
cristal (vidrio) → klisal, vitro
cristalero → klisalaqe, vitreqe
cristalería → klisalatia
cristianismo → kristianisma
cronómetro → klokometera
cruasán → croasan
cruce → crosa
crucificar → crosafikai
crucificción → crosafiktio
crujido → cruste
crujiente → crusto
crujir → crustai
cruz → crosa
cruzar → crosai
cráneo → craneo
crédito (de crear algo) → credito
crónica → cronike
cuadrado → qatrato
cuadro → kadro
cuadrícula → qatratiko, griya
cual → qal
cualquier cosa → ekoixa
cualquier forma → eforma
cualquier lugar → elocato
cualquier momento → etempo
cualquier → eione
cualquiera, cualquier persona → eperso, eixam
cuando → conde
cuanto → qanto
cuarenta → catroen
cuarto (habitación) → itela
cuarto (tiempo o matemáticas) → quarto
cuarto → catroix
cuatriciclo → quatroda
cuatrillón → catrilloe
cuatro → catro
cuatro → catro
cuba → cuba
cubo → kubo
cubrimiento → kubraia
cubrir → kubrai
cucaracha → mustanekro, mikoro
cuchara → boutsara
cuchillo → akuttere, nivo
cuello → pisotsa
cuenco → kisa
cuenta (números) → konta
cuenta → akanta
cuerda → resta
cuerno → corno
cuerpo → corpo
cuervo → corvo
cuestión → kuastion
cueva → encova
cuidado → culda
cuidar → culdei
culo → anusa
culpa → riaxa
culpable → riaxeso
culpar → riaxai
cultivo → kultivo
culto → culto
culto → litero
cultura → kultura, viri
cumpleaños → henyaro, natahen
cumplir → kumplaire
cupón → bone
cura (antídoto) → kura
cura , sacerdote → praisoxette
curar → kurai
curiosear → kuriosei
curiosidad → kurioseata
curioso → kurioso
curso → curso
curva → vira
cuártel → iritela
cuásar → quasar
cuña → cunna
cámara → camera
cáncer → cancer
cápsula → capsula
cápsula → kapsula
cárcel → cartsela, prison
cáscara (platano) → muzka
cátodo → catodo
célula → celula
césped → briaxa
círculo → circlo
cóctel → coktel
código postal → postalcodiko, postalcoda
código → codiko
cólera → xolera
cómodo → conforte
dado → dize
daga → diaga
dama → dama, mena
dar pereza → partsai
dar → bei
darse cuenta → indorai
dato → data
dañar → daxai, injurai
daño → daxa
de acuerdo → em akordo
de la → dala
de nada → non lanai
de todas formas → da alde forma
de → da
debajo → berora
deber (algo que debes) → dute
deber (colegio) → esaroidute
deber → dutei
decente → dezente
decepcionar → deteptionei
decidir → dezei
decir → dikerei
decisión → deze
declarar → declaire
decágono → decakono
dedal → fakro gid
dedo → gid
defecto → defekto
defender → defendei
defensa → defenda
defensor → defendette
deficiencia → defizientia
deficiente → defizente
definido → definite
definitivo → definite
degustar, saborear → zaporrai, degustai, degustoi
deidad → deida
dejado → dexaireioko
dejar → dexaire
del → dai
delante → daotan
deletrear → delektorei, espelei
delfín → delfino
delgado → delekio
demandar → demandai
demasiado → posmoi
democracia → democratia
democrático → democratika
demonio → damon
demócrata → democrato
dentadura → dentatia
dentista → dentaxette
dentro → intro
dentríficio, pasta dental → dentacrema
dependencia → dependentia
depender → dependei
depresión (montañas) → depresion
depresión (sentimientos) → depresia, depreia
deprimir → deprei
deprisa → rantio
depuración → puratio
depurar → purai
derecha → dereite
derivar → derivai
derramar → derramei
derrame → derrame
derribar → coarsai, derribei
desactivación → deaktivatio
desactivar → deaktivei
desagrupación → unagrupatio
desagrupar → unagrupai, unludei
desaparecer → unparezei
desaparición → unparezeitio
desaprobación → deaprovatio
desaprobar → deaprovai
desarrollar → deurrayai
desarrollo → deurrayo
desastre → disastra
desastroso → disastroso
desatornillar → desexkrabaire
desbloquear → unlokei
descalzarse → unpoire
descansar → durnei, hixei
descanso → hixe
descender → denseine, aurei
descenso → densenno
descifrar → descifrei
desconchar → descontsai
desconectar → desconektai
desconocido → unmiseioko
descorchar → unarkutsai
describir → deskriptei
desde → daze
desear → dezeai, pregardai
desechado → desexo
desechar → desexai, zorrai
desecho, basura → desexo, zorro
desembarcar → desbarcai
desembarco → desbarco
desembocadura (río) → rioke
desengrasador → torqette
desengrasante → torqera
desengrasar → torqei
deseo → dezo, pregardo, agux
desfilar → deslinai
desfile → deslina
deshacer → undoi, unfai
deshecho → undono
desierto → deserto
desinstalar → uninstalai
deslizador → esleiner
deslizamiento → esleia
deslizar → eslei
desmayarse → dizkoiai
desmayo → dizkoia
desnudar → abiarei
desnudo → abiare
desnudo → abiare
despacio → lento
despedir → adei
despertar → loteire
desplazar → loamai
después → enter
destacado → boldako
destacar → boldai
destello → destelo
desterrar → desterrai
destino → desteno
destornillador → desexkraboro
destripar (tripas) → detripai
destripar, spoilear (serie) → enteire
destronar → detronei
destrucción → distro
destructor → distroro, distructor
destruir → distroi
desvariar → desvariai
desvario → desvario
detalle → detaila
detectar → detektoi
detergente → detergo
deterger → detergire
determinación → determinatia
determinada → determina
determinar → determinai
detrás → betran (dabetran)
deuda → dutia
diablo → devila
diagnosticar → diagnostikai
diagnóstico → diagnostiko
diagrama → deagrama
diamante → diamento
diana → nesiga
diario → hena
diario → hengia
dibujar → dixai
dibujo → dixo
diccionario → diktionario
dicho → dikero
diciembre → dicembro
dictador → dictatoro
dictadura → dictatura
diecinueve → dizinonio
dieciocho → diziocto
diecisiete → dizisepto
dieciséis → dizisexei
diente de león (flor) → sedara
diente → denta
dieta → dieta
dietético → dieteko
diez → dez
diez → dez
diferenciar → diferikei
diferente → nequalo
diferir → diferei
dificultad → derrenno
difícil → derrenko
digerir → dijerai
digito → digito
dimensión → dimensia
dinamita → dinamita
dinero, pasta → moneta
dinosaurio → dinosauro
diorita → diorita
dios → deis
diosa → deisa
diploma → diploma
diplomático → diplomaxette
dirección (hacia algo) → dirija
dirección (lugar) → direktia
dirección de correo → elektrikonio direktia
directiva → directiva
directo → dirijtiko
director → dirijette
dirigir → dirijei
disciplina, doctrina → discipula
disciplinar → disciplaire
disco → diske
discoteca → discotela, discoteka, disco
discreto → diskreto
discriminación → discrima
discriminar → discrimai
disculpar → diskaire
discípulo → disciplo
disfraz → desfro, vanga
disfrazar → desfroi, vangai
disfrutar mucho → aioioi
disfrutar → gozoi
disipar → disipaire
disolver → disolvai
disparar → desparei
disparo → desparo
disponer → disvai
disponibilidad → disva
disponible → disve
disposición → disposa
dispositivo → alitaro
disquete → diskete
disrupción → disrupta
disruptivo → disruptivo
disruptor → disruptor
distancia → longara
distanciar → longoai
distante → distante
distrito → distrikto
diversión → xiaibela
divertido → xiabeloso
divertir → xiaibelai
dividir → diproxei
divisa → divisa
división → diproxo
divisor → dipre
doblar → fluksai
doce → dizidois
doceavo → dizidoisix
doctor → doktor
doctoral → doktoralo
documento → dokumento
dodo → dodo
doler → dolei
dolor → dole
domingo → dominko
doméstico → domestixo
donde → donde
dorar → aurai
dormir → dormei
dormitorio → dormeiun
dos → dois
dos → dois
dragón → dracono
drenar → drenai
droga → drojo
dromedario → dorgo
ducha → tsoaga
duchar → tsoagai
duda → duba
dudar → dubai
dueño, dueña → donno
dulce → dultse
duplicar → duproxei
duración → dula
durante → koante
durar → dulai
duro → tsosto
dársena → portakarga
débil → debila
décimo → dizix
día → hen
dólar → dolar
ebullición, evaporación → inherba
echar → etsoi
ecología → ecologia
ecológico → ecologike
ecuador → equator
edición → editio
editar → editei
editor (persona) → editette
editor (programa u objeto) → editoro
efectivo → efektibo
eficiente → efizente
egipto → egipto
ejemplo → exemplo
ejercer → ecersai
ejercicio → exersizo
el → ei
el, los → ei
electricidad → elektritia
electrón → elektronno
electrónico → elektrikono
elefante → estsondo
elevar → levai, airoei, quai
ella → eila
ello/eso → so
ellos (objeto, no se usa pero se mantiene por legacy) → soit
ellos → eire
eléctrico → elektriko
embalar → embalai
embarcadero → embarcatero
embarcar → embarcai
embarco → embarco
emisor → emitero
emitir → emitei
emocionar (emoción) → emozai
emoción (emocionar) → emozio
emoción (sentimiento) → emotia
emotivo → emotivo
empalmar → apalmai
empalme → apalme
empanada → ebritaita
empanadilla → ebritaitita
empanado → ebrite
empanado → ebrito
empanar → ebritai
empapelar → empaperai
empatar → ligai, tai, tiai,
empatía → maiso
empeorar → heunei
emperador → emperos
emperatriz → emperas
empezar → estaire
empotración → empotratio
empotrar → empotrai
empresa → enterprisa, kompania
empujar → pujai
empuje → puja
en el → en ei, eni
en fin → baine
en serio → en real
en → en, em
encantar → enkantai
encanto → enxanto, encanto
encegar → blindai
encender → onoi
encendido → on
encerado → equo
encerar → equai
encerrado → rekluido
encerrar → enkerraire
encestar → cestai
encharcar → culdai
enchufar → plugai
enchufe → pluga
enciclopedia → enciklopedia
encima → overa
enclave → entsave
encoger → nograi
encontrar → zunaire, trovai
encuesta → contesta
encuestar → contestai
endemia → endemos
endeudado → dutiako
energía → eneryia
enero → januaro
enfadado → rutsuko
enfadar → rutsuei
enfadar → rutsuei
enfado → rutsu
enfermar → ebilai
enfermedad → ebila
enfermero → ebilaxette
enfermo → ebilo
enfrente → imfranto
enfriamiento → aigeisa
enfriar → aigei
engaño → lerra
engordar → lubai, fataine
engranaje → giar
engrasar → asoai
enlace → linke
enlazar → linkei
enmarcar → makorai
enmohecer → moldoi
enrutador → enrotare
ensalada → ensalada
enseñar → esaroi
ensordecer → sordai
ensuciar → druxai
entender → enderei, comprei
entendimiento → enderia
enterrar → enterrei
entidad → entita
entierro → enterro
entonces → urte.
entrada → entratela
entrar → entrei
entre → eintre
entregar → entregai
entrenar → traine, entraine
entronar → atronei
entropía → entropia
envejecer → igernei, okoire
envenenar → zisai, ponzai
enviar → darai
envío → dario
enzima → enzima
epidemia → epidemos
equipo → eqipo
equivalente → eqivala
equivaler → eqivalei
ergonomía → ergonomia
ergonómico → ergonomo
erizo → jedogo, pinkiporke
error → erra, mistaco, faio
escala → eskala
escalar → escalarei
escalera → escalatorra
escama → eskama
escandalizar → estantsai
escarabajo → karabajo
escena → estena
esclavizar → eslavai
esclavo → eslavo
escoba → furra
escobilla → furrisa
escocer → eskozei
escolta → eskolta
escoltar → eskoltoi
esconder → jidei
escopeta → busterre
escopetazo → buste
escorpión → escorpio
escozor → eskozo
escribir → izkribei
escrito → izkriba
escritura → izkribatia
escroto → escroto
escuadrón → escuadra
escuchar → eskotsai
escudo → seldo
escurrida → guta
escurridor → gutaoro
escurrir → gutarei
escándalo → estantsa
ese, esa, esas, esos → eisa
esencia → esentia
eslavo → eslava
esmeralda → emeralda
espacio en blanco → biancara
espacio → espatio
espada → raiyoa, suarda
espadaña → dragonkane
espagueti → espageti
espalda → betranno
esparto → esparto
españa → espanna
español → espannol
especial → espezial
especialidad → espezialitata
especializar → espezialitai
espectador → espekteixette
espectar → espektei
espectáculo → espectaclo
espejo → espelekto
espeleología → espelologia
espera → herre
esperantista → esperantesta
esperanto → esperanto
esperanza → aikala
esperar (esperar algo) → aikalai
esperar (tiempo) → herrei
espesar → hexegai
espeso → hexego
espesura → hexegia
espina → tira
esposa → meixa
espuma → hixa
espíar → espai
espíritu → espirita
esquema → eskeme
esquemático → eskemeko
esquina → eskina
esquinazo → eskinata
esquivar → inzei
esquive → inze
establecer → setei, establezei
establecimiento → establezimento
establo → ayatotela
estación (del año) → tempora
estación (tren) → parada
estadio → estadia
estado → estatio
estados unidos → estatioit yoiko
estafador → lerrako
estafador → lerrako
estalactita → espeleoka
estalagmita → espeleona
estallar → aixai
estallido → aixo
estancia → estanzia
estanco (donde comprar tabaco y sellos) → licentela
estandarte → estantaro
estante → axele
estantería → axelva
estar de pie → estandai
estar de pie, estante → estante
estar → astei
estatua → estatua
estaño → tenno
este → este
este, esta, estas, estos → eita
esternocleidomastoideo → esternocleidomastoideo
estilo → estila
estima → estima
estimación → estimatio
estimar → estimai
estiramiento → punxe, tritso
estirar → tritsai, punxai
estiércol → tsisigra
estonia → estonia
estonio → estonesa
estrella de mar → marestrela
estrella → estrela
estresado → anorrako
estresante → anorrieren
estresar → anorrei
estropeado → errairiko
estructura → estrukta
estrés → anorro
estudiante → estarette
estudiar → estarei
estudio → estaro
estómago → ingeriun
estúpido → esporgo
eternidad → ertsekoidae, ertse
eterno → ertseko
etnia → etnia
eucalipto → arsuce
europa → europa
evaporar → inherbei
evento → evento
evitar → voitai, saire
exacto → exaito
exacto → xakto
exageración → hurro
exagerar → hurrai
examen → examen
examinación → examinatia
examinar → examinai, testai
excitación → enuse
excitar → enusei
excusa → excusa
excusar → excusai
experimentar → experimentai, testai, testei
experimento → testo, testifica, experimento
explanada → planiuno
explicar → esplaxai, espelai
explosivo → explodiko
explosivo → explodoro
explosión → bombeia
explotar → bombeire, explodei
exportación → exporte
exportar → exportei
expresar → expresei
expresión → expresio
expuesto → exposto
expulsar → aztai
extender → extendaire
extensión → extentia
extinguir → extingei
extintor → ignoextingoro
extraer → tractaine
extrañar → estrannai
extraño → estranno
extraño, desconocido → estranne
extremo → extremo
extremo → extremo
extrovertido → extroverto
eyaculación → guma
eyacular → gumoi
facilitar → fazilai
falda → fuana
fallar → errai
falso → fakro
falta → faita
faltar → falai
familia → pailako
familiar → pai
favor → fevo
favorar → favorai
febrero → febrero
fecha → daita
felicidad → aibela
feliz, alegre → aibelo
feo → utego
feo → utego
feria → faira
festejar → partai, faire, festai
fetiche → fetixa
feto → feto
fez → fez
fibra → fibre
fideo → fixoa
fiebre amarilla → fever mallea
fiebre → fever
fiel → faiette
fieltro → feltro
fiesta → festa, parta, faira
figura → figura
fila → linia
filo → fila
filoso → filaso
fin de semana → finaolexo
fin → fin
final → finale
finalizar → finalei
finito → finiko
fino → estretso
firmar → sennei
flamenco → flamingo
flamenco → flaminko
flash → flash, flax, bliqa
flauta → fluta
flecha → fletsa
flor → floira
flora → flora
florecer → floirai
flotar → flotai
fluido → flogo
fluir → flogai
fobia → fobia
foca → purra
fogata → fogo
folclore → folklore
follar → folai, sukai
fondo → fondo
fonética → fonetika
forma → forma
formación → formatio
formar → formai
formato → formato
formular → formulai
fortuna → heleria
forzado → forzaioso
forzar → forzai
fosforo → fosfuro
fracción → fraktio
fractal → fractal
fragmentar → fractai
fragmento → fracto
francia → francea
francotirador → ardespaire
francés → francesa
frase → zance
fregar → mopai
fregona → mope
freidora → friteoro
frenar → freine, detrei
frente → urante
fresa → fresa, estserra, rutsia
fresco (cuando se trata de algo novedoso) → siske, heruo, fresko
fresco → fresko
fresia (flor) → calanula
fresno → katria
fresón → frerna
freír → fritei
friki → weabu
friki, sabido → goko
frisbee → frisbee
frito → frito
frito → frito
frotar → frotsai
fruta → fruki
frío → aige
frío → aigeloso
fucsia → fuksia
fuego → igno, foko
fuelle → fluma
fuente (origen), origen → origo
fuente → fonto
fuera → fora
fuerte → forte
fuerza → forza
fuga → fuga
fular → fulard
fumador → esmokaiette
fumar → esmokai, inzai
fumigar → fumigai
funcionar → funzai
fundición → fuseitela
fundir → fusei
funeral → funeral
fusil → fusil
futuro → futura
futuro → proximo
fácil → fazilo
fé → fai
fístula → fistula
fórmula → formula
fútbol → futbola, poibola
gafas → visoioroit
galería → galila
galleta → putsa
gallina → conto
gamba → ximbrarisa
ganadero → eskiate
ganadería → eskiaro
ganar → gonai
gandúl → sugarriyo
gandúl → sugarriyo
ganso → guse
gardenia (flor) → gardenia
garra → giarra
garrapata → giarrapoita
gas → gas
gasolina → gasola, nitor
gastar → gastai
gato (animal) → kato
gato (herramienta) → criketa
gaviota → tagaro
gel → gel
gemelo → gineko
gemido → kemeido
gemir → kemir
gen → gene
generación → espauna
generador → espaunaoro
general → general
general → general
generar → espaunaire
genial → genelo
genio → genio, ginio
gente → gente
geranio (flor) → galina
geranio → alisla
gilipollas → sudatso
gimnasia → gimnasta
gimnasio → gimnastela
girafa → gerafe
girar, virar → virai
girasol → solavisa
giro → viro
glaciar → gielplaniuno
gloria → gloria
glotón, goloso → glutonno
gobernar → governei
gobierno → governo
gofre → xafla
golem → golem
golfo (geografía) → girufa
golpear → puntsai, bumpai
goma (herramienta) → prusaioro
goma (material) → goma
gordo → lubo, fato
gorila → korila
gorra → capa
gorro → gorro
gozar → gozei
grabación → grabatio, recordo
grabar → grabai, ikrabai, recordai
gracia → graze
gracias → grazei
gracioso → grazero
grado → grado
grande → oxto, grata, magna
granito → granita
granizo → aigecombe
granja → granja
grasa → lipuda
gratis → atsoko
gravedad → gravita
graznar → cuacai, graznai
graznido → cuaqio, grazne
grieta, raja → raca
grifo (agua) → espigoto
grifo (animal) → grifo
grillo → audixora
gripe aviar → acriko flubila
gripe española → espanna flubila
gripe porcina → porko flubila
gripe → flubila
gritar → klizei
grosero → uskoro
grueso → groso
grupo → lude, grupo
grúa → gruva
guante → luva
guapo → emelo
guardabosques → madrasaivaixette
guardado → gaiza
guardador → gaizeoro
guardar → gaize
guardia → guarda
guarida → guardia
guay → yuolo
guerra → gerra
guerrero de fuego → antias
guiar → redai
guijarro → giarra
guisante → pite
guitarra → gitarra
gula → glutonia
gusano → guro
gustar → gustoi
guía (objeto) → redaioro
guía (persona) → redaixette
género → genera
haba → aba
haber → harei
habilidad → estila
habitación → vitaitela
hablar sin saber → farlai
hablar → paire
hacer reir → sigisai
hacer un tour → turei
hacer → doi, fai
hacerrisas → gisette (persona que intenta hacer gracia de manera común pero solo es molesto)
hacerse una paja → oargai
hacia abajo → aurnara
hacia arriba → airnara
hacia atrás → dabetranara
hacia delante → daotanara
hacia la derecha → dereitenara
hacia la izquierda → zoraitenara
hacia → haiza
hackear → hackei
hada → farura
halcón → halokun
hambre → zugra
hambruna → urzugra
hamburguesa → burgesa
hamster → peirala, milia
harina → hegoa
harpía → harpea
harto → rakoso
hasta → haita
hasta → haita
hechicero → xicero
hechizar → xizai
hechizo, conjuro → xizo
hecho → facto
helado → freskingo, gelato
helecho → ferna, honko
heliconia (flor) → gingola
helsinki → jelsinki
heno → tseno
herida → daxe
herir → daxei
hermana → meileko, herna
hermanastra → inestmeileko
hermanastro → inestholeko
hermano → holeko, brodo
herradura → ayatuko
herramienta → horo
herrero → herrexette
herrería → herretela
hervir → herbei
heterosexual → heterosexualo
heterosexualidad → heterosexualita
hexágono → hexakono
hidrángea → hidranyea
hielo → gelo
hierba → herba
hierro → herro
hijastro, hijastra → inesteko
hijo, hija → eko
hinduismo → hinduisma
hindú → hindu
hipodromo → ayatela
hipopótamo → huragere, hipo
historia → historia
hogar → heiga
hogareño → heigaro
hoguera → ignixa
hoja → fola
hola → hai
holanda → holande
hombre → honperso
homenaje → homenaie
homenajear → homenaiar
homicida → homicida
homicidio → homicidio
homosexual → homosexualo
homsexualidad → homosexualita
hongo → likena, fungo
hora → hora
horizonte → horizone
hormiga → nekroandaivo
hormiguear → mitsisilai
hormigueo → mitsisila
hormigón → concreto
hornear → fornai
horno → forno
horóscopo → horoscope
hospedaje → huste
hospedar → hustoi
hostelero → hostexette
hostelerías → hosta
hostia → portona
hotel → hostala
hoy → nauhen.
hueso → hoso
huevo → ovo
huir → ezurrai
humanidad → homoia, humanita
humano → homo
humo → esmoke
humor → zizge
huracán → hurakana
huérfano → horfano
huésped → husxette
hélice → gingilla
hígado → hexinra
húmedo y profundo → heruo
húmedo → hemo
icono → icone
idea → idea
idear → ideai
idioma, lenguaje → lango
idiota → hunko
iglesia → eklesia, praisotela
igual → equalo
ilimitado → unlimiteko
imagen, foto → imake, pikto
imaginación → imaginatio
imaginador → imagineiko
imaginar → imaginei
imantar → magnetai
imbécil → sunkrako
imperio → imperia
importante → hembo, mora
importar → hembei, morai
imposible → imposibla
imprenta → izkratasoro
impresionable → impresable
impresionante → impresivo
impresionar → impresei
impresión → impresio
impreso → izkrasato
impreso → izkratoso
imprimir → izkratarosotei
impulsar → bustai
impulso → busto
imán → magneto
inaccesibilidad → inakcesibila
inaccesible → inakcesibla
incar → hincai
incertidumbre → inzertidumbre
incienso → incenso
inclinar → inklinai
incluir → includei
incomodidad → inconforta
incubación → incube
incubar → incubai
inculto → ivorte
inculto → unlitero
incómodo → inconforte
indecente → undezente
india → hindea
industria → industria
infierno → inferno
infijo → infikso
infinito → unfiniko
inflación → inflatio
influencia → influentia
influenciar → influai
información → informa
informar → informei
infracción → frakza
infravalorado → aurvaluako
infusión → infuzio
ingeniar → enginaire
ingeniero → enginero
ingeniería → engineria
ingenio → enginio
inglaterra → angloterra
inglés → anglo
inhalar → inselei
iniciar sesión → entrei en sesia
iniciar, comenzar, empezar → initiai
inicio → initio
inmortal → inmortal
inmune → inmuno
inocencia → inocentia
inocente → inocente
inocente → inocente
insaciable → insatiable
inscribir → azkribei
insecticida → insekticida
insecto → insekto
inserción → inserzo
insertar → inserei
instalación → instalatio
instalador → instaloro
instalar → instalai
instancia → instancea
instantáneo → instantako
institución → instituzio
instituto → aito-esaroriun
instrumento → instrumento
insulto → insulto
insulto → retro, insulso
intelecto → intelekto
intelectual → intelektualo
intencional → intentiente
intención → intentio
intentar → trei
interesante → interesanta
interesar → interesai
internet → interneta
intervalo → interval
intestino delgado → piko intestino
intestino grueso → oxto intestino
introvertido → introverto
intrusear → intrudai
intruso → intrudo
investigación → edarotio
investigador → edarotto
investigar → edaroi
invierno → aigelaria
invitación → invitatio
invitar → invitei
ir → hei
ira → ruztarro
iris (flor) → iris
ironía → ironika
irritado → ezirutsuko
irritar → ezirutsuei
irónico → ironiko
isla → isla
italia → italia
italiano → italeano
izquierda → zoraite
jabalí → diporko
jabón → moape, sapo, baxugo
jacinto (flor) → irsis
jade → jade
jalapeño → jalapenno
jamás → nontsai
jamás, nunca → nontsai.
jamón → iamon
japonés → japonesa
japón → japonia
jardinero → gardaxette
jardín → garda
jarrón, florero → diarra
jaula → xolda
jazmín (flor) → terisna
jefe → jefe, printsiale, antso, casca
jerarquía → jiderarqia
jersey → jersey, tuske
jerárquico → jiderarqiko
jirafa → terke, oxpisotsa
joder → injisai
joder → xograstei
jodida → frikenko
jornada → henata, iornada
joven → nevako
joven → neve, nevon
juego → joko
jueves → traxhia
juez → juksette
jugador → jokaiette
jugar (casino) → ludaine, ludai
jugar → jokai
juglar → joglar
jugo → xugo
julio → xulio
junco → hunco
jungla → jungla
junio → januo
junta → junta
junto → xa
justicia → iustika
justificar → iustikai
justo → iusto
juzgado → jukse
juzgar → juksei
júpiter → ivpiter
koala → koala
kosovo → kosovo
la, las → la
laberinto → mace
labio → labe
lado → sero
ladrar → guoi
ladrillo → brico, kuxa
ladrón → rovette, rovago
lago → laka
lagrima → lakrima
langostino → ximpo
lanza → espara
lapislázuli → lapislazuli
largo → longo
lasaña → lasanna
lascivo → invikso
lata → canna
lava → lava
lavado → xaguata
lavadora → xaguatoro
lavanda (flor) → lavanda
lavar → xaguai
lavavajillas → vadixaguaioro
leche → esnea
lechero → esneaxette
lechuga → letsuga
lectura → lekta
leer → lektei
lejano → foreno
lejos → fore
lejía → blanco
lencería → linzeria
lengua → lemgo
lentes → lendait
lerdo → tsafala
letra (canción) → lerite
letra (símbolo) → letra
levantar → levai, quai
ley → laia
leyenda → legenda
leña → lenna
leñador → madrakuxette
león → leon
liberar → liberai
libertad → libertia
libre → libero, liberso
librería → izbotela
libreta → izboiko
libro → izboto
licencia → licensa
licenciado → licenso
licenciar → licensaire
liderar → aderei
ligero → lito
lija → liya, afile
lijar → liyare
limitado → limiteko
limitar → limitei
limpiador → likraoro
limpiar → likrai
limpieza → likratia
limpio → likraiso
limusina → limusina
linguisitico → langoko
linterna → lanterna
liquen → liqen
lirio (flor) → mancuma
lisboa → lisbona
lista → lista
listo (persona inteligente) → listo
listo (preparado) → estedie, preparato
litera → litera
literal → literal
literatura → literatia
llama → lama
llamada → llamata
llamado → llamako
llamar → llamai
llanta → xenta
llanura → planitela
llave → klave
llegada → iriheia
llegar → irihei
llenar → elloi
lleno → elloko
llevar → yeveire
llorar → lakrimai, acoatai
llover → pluvai, acoatei
lluvia de balas → baletrumbe
lluvia de ideas → ideait-mixa
lluvia → pluva, acoata
lo que sea → oraben
lo → xo (cosa)
lobo → lauseto
local → locatako
loco → ankraro, friko
locura → ankraia
lodazal → ugrarda
lodo → ugra
lograr → lokrai
logro → lokro
lombriz → siguro
lomo → rame
londrés → londonia
longitud → longoteda
loro → locuo
los → eirer
lucha → fista
luchar → fistai
luciérnaga → blailita
luego → ogenter.
lugar → locata, itela
lujo → luxo
lujoso → luxoso
lujuría → luxuria
luna → luna
lunes → lunia
luz tenue → glima
luz → lita
lácteo → esneoro
lámpara → litaoro
lápida → mortopetro
lápiz → izkrioro
láser → lazer
látigo → latikate
líder → aderge, xefo
límite → limite
línea → linia
macarrón → makarron
maceta → mazeta
machacador → pestoro, morta
machacar → pestai, matsakai
madera → madra
madero → madreno
madrastra → inestmatrona
madre (formal) → matrona
madre → meipai
madrid → madrid
madriguera → maheiga
maestro → mastero
maestría → masteria
magdalena → magadia
magia → magia
magma → magma
magnetismo → magnetisma
magnolia (flor) → magnasia
magnético → magnetiso
majo → hali
mal → heun
mal → heun
malasombra → heuntsado
malasombra → heuntsado
maldito → mairato
maligno → heunxo
malo → heune
mamar → mamaire
mamut → mamuz
mancha → zugra
manchar → zugrai
mandar → mandai
mando (concepto) → manda
mando (objeto) → mandoro
manejar → turai
manejo → tula
manera → modo
manga (ropa) → maniga
mango (de utensilios) → manega
mango (fruta) → mango
manicomio → frikostela, ankratela, frikheiga
manifiesto → manifesto
manillar → manile
mano → man, hano
mansión → mansio
manta → kubre
mantarraya → manraia
manteca → manteca
mantener → ersai
mantequilla → mantega
manticora → mantikora
manutención → ersokio
manzana → menzana, pomo
mapa → mapa
mapache → mapatso, racune
mar → mare
marca → marka
marcador → markoro
marcar → markai
marcha → martsa
marchito → marxito
marcial → martiala
marciano → marteano
marco → makora
marfíl → utso
margarita → aukuba
marica, maricón → zager
marido → honxa
marioneta → pupeto
mariposa → blaigia
mariquita → zigarra
marisco → arraina
marrón → itsoso
marrón → marro, brunno, bronzo
marte → mairte
martes → martia
martillo → martexo
marzo → marzea
masa → masa
masacrar → masacrire
masacre → masacria
mascarada → maskerade, lufaz
mascarilla → mascarila, securitatia lufazia
mascota → heiganimal
masilla → masiya
masivo → masivo
masterización → masteratio
masterizar → mastereize
mastil → mastil
masturbarse → mastarai
matadero → mataioro, mataitela, abatoro
matar → mataire
matarratas → mortorratit
matemática → matematika
matemáticas → matematikas
material → materia
matraz, probeta → matrace, probacupa
matrimonio → zimisyoixo
matriz → matriks
maullar → mauiai
maullido → mauia
maximo → oxtorra
mayo → maio
mayonesa → maionesa
mayor → oxtorer
mayoría → oxtoro
maza → maza
mazorca (maíz, por ejemplo) → bontso
maíz → juca
mañana (hora del día) → manza
mañana → enterehen
me → ner
mear → piksei
mearte de miedo → pikseterroi
mechero → ignoro
media → media
mediana → mediana
medianoche → mitanito
mediante → trante
medicamento → medikare
medicina → medikar
medicinal → medikarer
medida → metirra
medidor → metera
medio (transporte, comunicación) → metia
medio → mediu
mediocre → mediocre
mediocridad → mediocrita
mediodía → mitaheno
medir → metairre
meditación → meditia
meditar → meditei
megáfono → megafono
mejor → bainodo
mejorar → bainei
mellizo → meliza
melocotón → apomo
melón → meloko
meme → meme
mena → vena
menaje → furnitia, menagio
mencionar → mentsei
mención → mentio
menor → pikoler
menos → menus
mensaje → mesaje
mensajear → mesajire
menta → menta
mente → mende
mentir, engañar → lerrai
mentira → musta
mentira → musta
mentiroso → mustager
menú → menu
mercurio → mercuria
merecer → dersei
merluza → xun, mutse
mermelada → iamela
mes → mes
mesa → lamadra
meseta → meseta
mestizo → seutse
metal → metala
meteorito, meteoro → meteoro
metro (medida) → metro
metro (medidor) → metroro
mezcla → mixa
mezclar → mixei
mezquita → mazquita
mi → nai
microondas → microhuaba
micrófono → microfono
miedo → terro
miel → mela
miembro (cuerpo) → membro
miembro (de un grupo) → membro
mientras → engeri
mierda → merto, keska
miga → minna
mil → ailla
mil → ailla
milenio → aillano
milicia → milizia
militar → miliette
milla → mila
millón → milloe
millón → milloe
mimo (cariño) → carica, memi
mimo (persona) → memo
mina → mine
minar → mineire
minero → minerette
minería → minatia
minoría → pikoloro
minuto → minute
minúsculo → miskolo
mirado → avisoko
mirador → avistela, mirator
mirar (mira, no sé que) → siet
mirar → avisei
misionar → mesigai
misionero → mesigette
misión → mesiga
mismo → mesmo
misterio → misteria, edaro
misterioso → edariko
mitad, medio → mita
mitigar → mitigaine
mito → misto
mitómano → mitomane
miércoles → xeitore
mochila → esaibaga
moco → muco
moda → siska
modalidad → modole
moderador → moderaiette
moderar → moderai
modificación → modifikatio
modificado → modifikako
modificar → modifikai
modo → modo
modular → modulai
mofeta → napesta
moho → moldo
momento → tempeo
moneda → pinne
monetario → monetareo
monitor → dorimeder
mono → monki, aco
mono → neko
monociclo → monorroda
monstruo → monstro
montar (montar algo) → montai
montar (montar en algo) → overai
montaña → montanna, ampico
monte → monto, monde, monte
montículo → kieva, montinna
montón (cosas) → buntso, cumo, kieve
montón (es un montón!) → plenti
monóculo → monoklo
moqueta → mokete, moqete
mora → blurra
morado → morato
morado → purpuro
morir de hambre → estarvai
morir → mortei
mortal → mortal
mortero → morta
mosca → blainekro
moscú → mosku
mosquete → muskete
mostrar flash → bliqai
mostrar → dorimei
motivo → motivo
moto → motorroda
motocicleta → motorroda
motor → motor
motosierra → motorxerra
mover → movai
movimiento → mova
muchas gracias → naito grazei
mucho → naito
muchos → naito
mudo → unpaireko
mueble → furno, moblo
muerte → morto
muerto → morte
muestra → dorima
mujer → meiperso
multiplicar → multiproxei
mundial → mondola
mundo → mondo
munición → amunitio
murciélago → vesperilo, murelo
muro, pared → mura
musgo → moso
mutar → mutai
muy cerrado, casi sin ventanas o puertas → zakerro
muy → moi
mágica → magika
máquina → matsina
más → mais
máscara → lufazia, maske
médico → medikarette
méxico → mexiko
místico → mistica
módulo → modulo
móvil → mobila
música → musika
música → musikette
nacer → natai
nacimiento → natatia
nacionalidad → agizaia
nada → nokoixa
nadar → nataire
nadie → noperso
napolitana → miniga
narciso (flor) → nersu
nariz → vono
natural → naturala
navaja → navaia
navidad → neven
necesidad → traia
necesitar → trai, opaine
nectarina → nipomo
negación → noneatio
negar → nonei, nekai
negativamente → nekatikoien
negativo → nekatiko
negro → nekro
nenúfar → nufara
neptuno → neptuno
neumático → kotsira
nevado → aigeloso
nevar → aigelai
nevera, frigorífico → ingoesmar
nido → nesta
nieta → meioeke
nieto → umoeke
nieve → aigela
nigromancia → nekromantia
nigromante → nekromante
ninguna forma → noforma
ningún lugar → notela, nolocato
ningún momento, nunca → nontsai
ningún → none
nitrogeno → nitroieno
nivel → levela
niña → nenna
niño → kindo, infante, nenno
niños (conjunto) → kindara
no te metas → non entreiet
no → non
noche → nito
nogal → nuzelara
nombrar → nombrai
nombre → nome
norma → norme
normal → normal
normalizar → normalai
norte → norto
noruega → norkia
noruego → norkeo
nos → narer
nosotros → nare
nota → nota
noticia → neva
notificación → nevari
notificar → nevai
novedad → nevotia
noveno → nonoix
noventa → nonien
noviembre → novembo
novio, novia → loimike
nube seta → likenimbo
nube → nimbo
nublado → nimboso
nuclear → nuzelar
nudo → nude
nudo → nukra
nuestro → narei
nueva york → nevo york
nueve → nonio
nueve → nonio
nuevo → nevo
nuez → nuzel
numerar → numai
nunca → nontsai
nutricionista → dietexette
néctar → nektar
níscalo → niscalo, mixuia
núcleo → kora
número → numo, emesimo
obispo → bispo
objetivo → asiga
objeto → item
obtener → elokrai
obvio → obeo
obvio → obeo
oca → malira
oceanía → ozeania
ochenta → octoen
ocho → octo
ocho → octo
octavo → octoix
octubre → octambo
octógono → oktokono
ocultar → jidei
ocupación → osala
ocupado → osalo
ocupado → osalo
ocupar → osalei
ocurrir → idurei, zaine
océano → oxtomare
odiar → rutrai
odio → rutro
oeste → oeste
ofender → ofensire
ofensa → ofensa
ofensivo → ofensoko
oficina → ofizina
oficio → ofizio
ofrecer → ofrerai
oir → oi
ojalar → oixalai
ojalar → oslai
ojo → exo, ogo
ola → guaira
oler → eslei
olla → kalerkista
olmo → elme
olor → eslo
olvidado → supardo, oblivo, husko
olvidar → supardaire
olvido → huske, suparde
once → dizixone
onceavo → dizixoneix
onda → huaba
opción → setegia
operar → improxei
oportunidad → eiasa
optimizar → optemizei
oración → oratio
orangután → ursunna, nono
orchata → esnika
orden (de orginazar) → surdo
orden, ordenación → ordo
ordenador → computera
ordenar (de ordenar a alguien) → ordenai
ordenar (de poner orden a un lugar) → surdai
oreja, oido → oitio
orfanato → horfanatela
organismo → organismo
original → origelo
originar → origai
orla → aserna
ornitorrinco → tuputa
oro → aurio
oronja → oronya
orquesta → orqesta
orquestar → orqestai
orquídea (flor) → ortsida
ortiga → urtica, migera
orégano → parxa
os → zurer
oscuridad → obskuridae
oscuro → obskuro
oso → aubaso
ostentar → glezai
otoño → autonno
otra cosa → okoixa
otra forma → oforma
otra vez → aran
otra vez → retai
otro (persona) → ote
otro lugar → otela, olocato
otro momento → otempo
otros (cosas) → otem
otros (personas) → oter
oveja → omejo
oxidado (de hacer algo) → rigi
oxidado (metal) → ragiko
oxidar[se] → ragiai
ozono → ozone
paciencia → pacenza
pactar → pactoi
pacto → pacto
padrastro → inestpatrono
padre (formal) → patrono
padre → honpai
paga → paia
pagano → pakano
pagar → paiai
paja (heno) → likra
paja (sexo) → oarga
palabra → vorto, palabra
palabrería → vortatia
palanca → palanca
paliza → puntsatarra
palma → palme
palmera (árbol) → irakoa
palo → apika, cano, cana
paloma → rago
pan de molde → anglobrita
pan → brita
panadero → britaxette
panal → panala
pancreas → pancras
panda → panda
pandemia → pandemos
panel → panela
pansexual → pansexualo
pansexualidad → pansexualita
pantalla → visaya
pantalón → panto
pantano → saguala
pantera → pantera
papel → pipra
papelera, cubo de basura → graxkubo, zorrera, zorrere, desextela
papelería → pipratela
paquete (insulto) → tsusta
paquete (insulto) → tsusta
paquete (objeto) → paketara
paquete → paquete
par → pare
para → paira
paracaídas → paratsute
parafilia → parafilia
paraguas → pluvaoro
paraguay → paraguai
parar, detener → estoi
parasol → estosol
parecer → aseire
pariente → pai
parir → parei
paris → parisa
parking, aparcamiento → parakia
parpadear → exorei
parque → parke, jokotela
parrilla → grila
parroquia → parroqia
parte → parte
partida (juego) → jokaizara
partido (juego, deporte) → jokaizera
partido (político) → partero
partir → partei, brokai
pasado mañana → pos→enterehen.
pasado → pasato
pasado → pasato
pasamontañas → balakava
pasar (caminar) → paize
pasar (ocurrir) → zaine
pasear → paize
paseo → andaiata
paseo → paizo
paso de zebra → rakempisa
paso → pisa
pasta (comida) → fixolo
pastar → pastaixe
pastel → kutsa, boglo
pasteurizado → pausteriko
pasteurizar → pausterai
pastilla → gobo
pastor → pastoro
pastoso → pastoso
pata (animal) → pezna
patada → poitsa
patata → torkopa, tata, papa, potata, patata
patear → poitsire
patio → enkampe, kampe
pato → ana
patria → onterra
patriarca → onterrarge
patriótico → onterriko
patron → patronna
pausado → pauxaioko
pausar → pauxai
payaso → payaso, xiabette
paz → paz
país → landa, agiza, paiseko
pañuelo → pannola
pecado → xina
pecar → xinai
pecera → pesketela
pecho → korata
pechuga → same
pedido → orden
pedir → precai
pedo → fargo
pedorro → fargustarra
pegamento → pasta
pegar → pastai
pegatina → pastenno
pegatina → pastika
peine → cailoro
pelador de patatas → torkopeler
pelador → peler
peladura → pelde
pelaje, cuero → cuoro, peltro
pelar → pelai
pelear → faitai
peletero → cuorette
peligrar → perilai
peligro → perila
peligroso → perilko
pella → peia
pelo, cabello → cailo
pelota, bola → bola
pelotudo → pilotufeso
pelotudo → pilotufeso
peluquero → cailoxette
película → filmo
pender → pendei
pene → penisa
pensador → penzeiette
pensamiento (mente) → penze
pensamientos (flor) → siakara
pensar → penzei
pensativo → penseivo
pentágono → pentakono
peonza → virante, rotaio
peonía (flor) → aravita
peor → heunodo
pepinillo → frico
pepino → pepera
pequeño → pikolo
pera → pera
perca → eskada
percha → pertsa, colca, colga
perder → pardaire
perdido → pardeyoso
perdonar → pardonai
perdón → diskaire, pardon
perecer → peretai
pereza → fiagia, partsa
perezoso (animal) → fiager
perezoso (persona) → fiago, fago
perfeccionar → perfektei
perfección → perfektio
perfil → profila
pergamino → perge
periodista → henpixette
periódico → henpipra
periódico → yere
perla → perla
permanecer → unfinai
permanente → unfinaloko
permiso → permiso
permitir → permisai
pero → nur
perro → doerro, hundo
perseguir → prosecai
perseverancia → persevera
perseverar → perseverai
persiana → yera, jerco
persistencia → persivita
persistir → persiverai
persona → perso
personal → personale
personal → pertsonala
personalización → personalizatio
personalizar → personalizei
pesa → pesa
pesado (persona molesta) → orronko
pesado (peso de una cosa) → pesoko
pesar → pesai
pescadero → peskoventei
pescadería → peskotela
pescado → peskoto
pescador → peskorette
pescar → peskei
pesebre → bestingoro
peso → peso
pestaña (informática) → tabula
pestaña (ojo) → exogi
pestañear → exorei
peste antonina → antonine pesta
peste negra → nekro morto
peste → pesta
pesto → pesto
petrolero → nekrasobarco
petróleo, crudo → nekrasoa
petunia (flor) → porpura
pez → pesko
peña → penna
peñasco → pennasco
piano → piano
picadura → estundaxe
picar (bicho) → estungai
picar (minar) →
pico (animal) → pike
pico (herramienta) → pikote
pico (montaña) → ampico
pie → poi
piedra → petro, petra
piel → pelde
pierna → airpoi
pieza → pieza
pijama → niki
pimiento → pipera
pincel → brutsa
pincelada → brutse
pincelar → brutsei
pinchar → pinkai
pinche (ayudante de cocinero) → adkoxine, koxinlada
pincho → pinko
pingüino → pingino
pino → pino
pintar → pintei
pintura (cuadro) → pintaia, pikto
pintura (objeto) → pinta
pipa → crutsa
pira (fuego) → pire
piragüa → piragua
piraña → piranna
pirámide → piramide
pirómano → piromane
pis → pikse
pisar → pisoi
piscina → acoakisa
piso, apartamento → empartamento, bloke
pista (sobre un misterio) → hanta
pista de baile → danzeplane
pistacho → petsula, pistatso
pistola → pistola
pizarra (escuela) → zirraplane
pizarra (material) → ekurga
pizza → pizza
pizzería → pizzatela
piña → pinna, anani
placenta → ecombe
placer → pleasa
plaga de justiniano → plaga dai justiniano
plaga → plaga
plan → plan
planear (plan) → planoi
planear (volar) → planeai
planeo → planeata
planeta → planeta
planetoide → planetoido
plano → plane
plano → plano
planta petrolífera → nekrasoatela
planta → planta
plantar → plantaire
plata → silvo
plataforma → plataforma
platino → silverino
plato → plato
playa → plaia
plomo → blono
pluma (animal) → felisa
pluma (boligrafo) → pluma
plutonio → plutonio
plátano → banana
población → populatio
pobre → pora
pobreza → poratia
poción → potia
poco → piko
pocos → piko
poder → pontai
poder → ponto
poema → poema
poesía → poesia
polaco → polaka
polar → polare
policía → polizia
polla → naso
pollo → acriko
polo (helado) → polo
polo → pole
polonia → polakia
polvo → pulder
polén → polen
polígono → moltoxo
pompa → bobal, pompe
poner → posai
por cierto → por zerto
por cierto → por zerto
por defecto → nurdefekto
por favor → porqarei, porfevo
por lo que → soqe
por qué → por qa
por → por
porque → debai
porro → purro
portaaviones → portavionnit
portabandera → portafliaga
portabebés → portabekit
portavoz → portavoz
portero → portette
portugal → portugal
portugués → portuguesa
portátil → portatil
posar → posei
pose → pose
poseer → posesai
posesivo (lengua) → posesive
poseído → poseso
posibilitar → posiblai, posibilai, posibilitai
posible → posibla
posición → posaieo
posponer → posposai
postal → postal
posterior → enterier
pozo → racoia
practicar → praktikai
pradera → ergiara
prado → ergia
precio, coste → kosta
precioso → aibinna
precisar → prezisei
precisión → prezisio
preciso → preziso
predecir, predicar → predikei
predicado → predicado
predicador → prediqette
predicar → predicai
predicción → prediktio
preferencia → sesaia
preferir → sesai
prefijo → prefikso
pregunta → kuastion, kuasta
preguntar → kuastionei
premiar → premire
premio → premio, prizo
prender → fokai
prendido → foke
prensa → prenza
preocupación → lana
preocupar → lanai
preparación → preparatio
preparado (estar preparado para algo) → en tempeo
preparar → preparei
presentación → presentatio
presentar → presentei
presente → presente
presidente → presideixette, printsiale
presidir → presidei
presionar → presoi
presión → preso
presumir → priuzei
pretexto → endeba
prever → prevai
previsión → prevo
previsualización → previso
previsualizar → previsoi
primavera → acoatira
primero → onix
primo → teoleko
princesa → princese
principado → princeta
principal → printsiale
principal → printsiale, primer
principiante → initiaxette
principio, comienzo → initio
prisa → ranta
probable → probeko
probablemente → probekoien
probar (de manera científica) → prostei
probar → probai
probiótico → probiotiko
problema → problema
procastinar → procastinai
procedencia → proceda
proceder → procedei
procesador → procesoro
procesar → procesai
proceso → prozeso
procrastinar → procrastinei
producir → proteire
producto → produkto
profesional → profesionale
profesión → profesio
profesor → esaroette
profeta → profeta
profundo → sundo
programa → prokrama
programación → prokramatio
programar → prokramai
progresar → progresei
progreso → progreso
prolongar → prolongaire
promedio → promedia
promesa → priosa
prometer → priosai
promover → promovai
pronosticar → pronostikaire
pronto → ayenter.
pronóstico → pronostiko
propio → prope
proponer → petiai
propuesta, petición → petitia, precaia
prosperar → prosperai
prosperidad → prosperatia
prostituta → putarra
protección → protectia
proteger → protectai
protegido → protecto
proteina → proteina
proverbio → proverbio
provincia → provenza
prueba → proba
prímula → acuprila
príncipe → prince
próxima → entera
próximo → proximo
psicópata → psicopata
pua → pika
publicar → publikai
pueblo → popula
puede ser → paidi sei
puente → ponto
puercoespín → pigotira
puerro → leko
puerta → porta
puerto → porto
puesta de sol → solarga, solposai
puesto → posto
pulgada → pulgada
pulida → polita
pulmón → polmona
pulpo → pulpusa
punto de mira, diana → nesiga
punto → punto
puro → pura
puré → tritura
puta → puta
puto → puto
puñal → estavoro
página web → webpagena
página → pagena
pájaro → payoa, caco
párpado → exore
párrafo → parrafo
péndulo → pendulo
pórtico → portecum
público → publiko
público → publiko
que se jodan, a la mierda → injise
que → qa
quebrar → qibrai
quedada → quaro
quedar sin → ranaire
quedar → quaroi
quehacer → doidute
quemador → ignodoxoro
quemadura → ignodaxo
quemar → tsizirrei, ignodaxai
querer → qarei
quererte tanto a ti mismo hasta el punto de necesitar atención médica → ipsogirgirigarigarei (broma de april fools)
queso en polvo → pulverfruge
queso → fruge
quiebra → qibra
quien → qim
quince → diziqinco
quinto → qincoix
quitar → removai
quizá → qiza
racionar → rationai
ración → ration
radio (aparato) → radio
radio (elemento) → radio
rama → brianke
rana → acroa
rango → range
ranunculus → ranuncula
rascar → kikroi
rata → rata
ratio → ratio
ratón (animal) → roido
ratón (ordenador) → mouse
rayar → raiaire
rayo → raio
razonar → reasoi
razón → reaso
raíz → braine
reaccionar → reactai, reaktai
reacción → reaktio
reacción → reakto
reactor → reactoro
real → real
realidad → realita
realizar → ereasei
rebaño, ganado → eskio
rebozuelo → mallea turfa
recaudar → rekauroi
rección → rektio
recepción (juegos) → receptio
recepción (lugar) → receptela
receptar → receptei
receptor → receptoro
receta → receta
recetar → recetei
rechazado → retsaiko
rechazar → retsaire
recibimiento → recepta
recibir → receptei, recebai
reciente → reciento
recipiente → recipente
recluir → reklui
recluso → rekluso
recogedor (objeto) → rekainoro
recogedor (persona) - rekaixette
recoger → rekaine
recogida → rekaina
recomensar → reguardai
recompensa → reguardo
recompensado → reguarde
reconocer → kognai
recordar → rekordai
recorrer → enzurrai
recorte → rekuta
rectal → rectal
recto → recto
rector → rektor
recubrimiento, cápsula, protección, trinchera, nido, bunker, guarida → laira
recuerdo → rekordo, supte
recurso → rekurso
red local → neta locatako
red social → sozialneta
red → neta
redondo → circloko
reenvío → redario
referencia → refera
referenciar → referai
reflejar → espelektei
reflejo → espelektia
reflexionar → refleksei
reflexión → refleksia
refrescar → refreskei
regadera → rekaoro
regalar → regalei
regaliz → dultseza
regalo → regalo, presente
regar → rekai
región → regiono
regla → rekla
regresar → retornai
regreso, retorno → retorno
rehacer → redoi, refai
reina → reine
reinado → reina
reino → renno
reir → gisai
relación → relatio
relativo → relative
religión → relicro
reliquia → relicua
reloj de muñeca → klokonna
reloj → kloko, relox, horaviso
reluciente → enlitaro
relucir húmedo → acolaine
relucir → enlitai
remar → esguelai
remarcar → remarkei
remasterización → remasteratio
remasterizar → remastereize
remo → esguela
remolacha → grosatsa
remover → removai
remunerado → remoneiata
remunerar → remonetai
rendición → purna
rendirse → purnai
reno → kirko
renovar → renevoi
reparación → repaira
repentino → repentoso
repetidor → repeteoro
repetir → repetei
replicar → reproxei
reportar → reportei
representación → representatio
representar → representei
reproducir (vida) → prokraire
reproducir (vídeo) → dorimei
reptar → aurandaire, okroi
república → republika
resistencia → resistentia
resistir → resistai
resolución → resoleitio
resolver → resolei
respetar → respektei
respeto → respeto
respiración → rispera
respirar → risperei
responder, contestar → repostai
respuesta → reposta
restablecer → resetei
restar → deproxei
resultado → resola
retener → rentiei
retirar → retroi
reto → testa
retrasado → retartato, retardato
retrasar → retrai
retraso → retra
reunir → undizei
reunión → undizio
revivir → revivai
revocar → revokei
revólver → revolver
rey → rein
rezar → praisoi
rezo → praiso
rico → ritsa
riesgo → risko
rifle → rifle
rima → rima
rimar → rimai
rinoceronte → rino
risa → gisa
ristra → rister
ritual → ritual
rizo → rize
robar → rovai
roble → acaia
robo → rovo
robot → robot
roca → roca
roce → rotse
rodar → rodai
rodilla → gidilla
rojo → roixo
rojo → roxo
rol → rol
roma → roma
romance → romanze
romero (flor) → romo
romper → rompeire
romántico → romantiko
ron → rone
rondar → rondai
rosa → roixa
rosa → rosar
rotación → rotatio
rotar → rotai
roto → roto
rotulador → rotulaoro
rotular → rotulei
rotura → rotura
rozar → rotsai
rubí → ruby
rudo → bardo
rueda → roda
ruidoso → audixoso
rumano → romaneo
rumanía → romanea
rumor → unzuna
rumorear → unzunai
rusia → ruzia
ruso → ruzeo
ruta → rota
rutilar → gliai
ráil → riel
rápido → rante
récord → rekord, plusmarka
régimen → regimeno
río → acuokemno, riava
rótulo → rotula
sabana (bioma) → xabana
saber → onetai
sabiduría → onatia
sabor → zapor
sabroso → zaproso
sacacorchos → retrakorkoit
sacar → retrai
saciable → satiable
saciar → satiarei
saco → sak
sacrificar → sacrifai
sacrificio → sacrifitio
sagrado → sacro
sakura, cerezo → roixeral
sal → sale, sial
salado → sialato
salchicha → karnolon
saldo → saldo
salida → evokatela
saliente → evoke
salir → evokai
salmón → tsugo
salsa → sauza
saltador → pulaioro
saltamontes → herbepulai
saltar → pulai
salto → pula
salud → vitaiko
saludar → haiai
saludo → saluto
salvaje → savaxo
salvapantallas → visayagaizere
salvar → saivai
salón → asteitela
san valentín → st. valentino, sainto valentino
sanar → sanai
sancionar → sanziarei
sandalía → sande
sandía → roxomelo
sangrar → sigrai
sangre → sigra
sanidad → sanita
santo → sainto
santuario → saintotela
sapo → froga
sargento → sarjento
sartén → emfriteoro
saturno → saturno
sauce llorón → zaprusa
se fueron (relacionado a sentimientos o conceptos) → dexaire
se → eir
secador → drioro
secar → driai
sección → sektion
seco → eskarra
secreto → sekreto
secreto → sekreto
secta → sekta
secuencia → sequencia
seda → seda
sedar → sedai
sede → primertela
seguir → sigai
segundo → doisix
segundo → sekundo
seguridad → securitatia
seguro (algo que asegura) → secur
seguro → securo
según → ezer
seis → seksei
seis → sexei
seleccionado → selekteioko
seleccionar → selektei
sello → seldo
semana → olekso
semanal → oleksaia
semen → bila
semilla → semila
sencillo → sencille
senda → kemno
sentado → siteiko
sentar → sendai
sentido → senso
sentimiento → sensira
sentir → sensei
separado → unyoiko
septiembre → septembro
septimo → septoix
septágono → septakono
sepultar → sepultai
sepultura → sepulta
sequía → dria
sequía → eskarratia
ser → sei
serio → serio
serpiente → serpento
serrería → madratela
servidor → sirveidoro
servir (servicio) → servei
servir (uso de algo) → sirvei
sesenta → sekseien
sesión → sesia
seta, champiñón → tsampinna
setenta → septoen
sexo → sexo
sexto → sekseix
seña → sinna
señal → sinna
señalizar → sinnai
señor → sire
señora → sira
si (afirmación) → ai
si (condicional) → si, se
si → ai
siempre → ertsai.
sierra → xerra
siete → septo
siete → septo
siglo → ozeno
significado → mea
significar → mearei, daine
siguiente → arenko
silenciar → esparei
silencio → esparo
silencioso → esparoso
silla → senda
simple → simple, sampla
simpático → amaiso, simpo
sin embargo → orne
sin → nokoi
sincero → etristuro, sinzero
siquiera, ni siquiera → nonixa
sirena (mitología) → meimare
sirena (objeto) → sirena
sistema → sistema
sitiar → sitei
soberbia → superbia
soberbio → superbo
sobre → airo
sobre → overa
sobrevalorado → airvaluako
sobrevivir → survivai
sobrino → asineko
social → sozial
socializar → sozialei
sociedad → soziata
socio → sozio
sociópata → sociopata
soga → soka
sol → sol
solar, parcela → solar, parza
soldado, guerrero → gerraxette
solo → ekoro
solo → nokpo
soltar → soltai
solución → solva
solver → solvai
sombra → tsado
sombreador → tsadoro
sombrear → tsadoi
sombrero → tsadoya, horro
sonar → audei
sonido → soniko
sonreir → selai
sonrisa → sela
sopa → faba
sordo → sorda
sostener → sotenai, sotaine
soñador → pentsieko
soñar → pentsizei
suave → iabe, lige
subida → aira
subir → airei
submarino → submarine
subnormal → tardo, subnormailo
suceder (continuar) → enterai
suceder (suceso) → berai
suceso → bero
sucio → druxo
sudar → suetai
sudor → sueta
sudámerica → suramerika
suecia → suekia
sueco → sueko
suelo → piso
suerte → lagenda
sueño → pentsio
suficiente → sufizente
sufijo → sufikso
sugerencia → sugestia
sugerir → sugestei
suicida → suicida
suicidio → suicidio
suiza → suxiza
suizo → suxizo
sujetador → sujeizo
sujetapapeles → sujepipra
sujetar → sujei
sujetavelas → sujecandala
suliveyar, encantar → aloi
sumar → suproxei
superar → raize
superavit → superavit
superficie → supratela
supervisar → supervisoi
supervivencia → surviva
suplicar → supraxai
supto → supto
sur → sur
surgimiento → sagetia
surgir → sagei
suscribir → suscribai
suspender → reprovai
suspensión → reprovatio
suspenso → reprovo
sustancia → sustancea
sustantivo → nambiro
sustento , sostención → soteno
susurrar → huxai
susurro → huxa
sutil → piskizo
suyo (usted) → zeu
suyo → eie
sábado → hixtane
sábana (cama) → xiaga
sílaba → silaba
símbolo → simbolo
síndrome → sindroma
sólido → solido
tabaco → tavake
taberna → ingotela, taverna, taberna
tabique → privono
tabla → tablo
tablero → tablote
tacaño → takanno
taco → taco
taiga → taiga, karzufisi
taladro → talatro
talar → tsopar, tambar
talco → talco
talla → rango
tallin → taline
tallo → rute
tamaño → tamanno
también → aiete
tambor → tampol
tamizar → tamizei
tampoco → nonete
tan → asle, tan
tan → tan
tan → tan
tanque , vehiculo de guerra → basta
tanto → tante
tantos → naitoxe
tapar → supai
taparabos → sujenasoit
tardar → egentai
tarde → egente.
tarde → taren
tardío → enterino
tarjeta, carta de naipe → carde
tarrina → tarra
tarro → tarro
tarta → tarta
tarántula → tarantula
taza → ukisa
te → zer
teatro → aktotela, tetero
tecla → tekla
teclado → teklatablo
tecnología → texnologia
tecnológica → texnologika
teja → teja
tejado → airplane
tejedora (máquina) → beilaoro
tejedora (persona) → beilaxette
tejer → beilai
tejido → beila
tejón → usetse
tela → ila
telar → ilaoro
teletransportar → teleportai
televisión → televisoi
teléfono → telefono
tema → subyecto
temblar → gaxei
temblor → brusta
temperatura → tempera
temprano → yonto.
temática → subyectata
tender → ibsoi
tendero, vendedor → venteixette
tenedor → tinera, trintso
tener → taine
tenis → tenis
tensar → tentai
tensión → tentia
tentar → soblasnei, movai
tercero → triaix
termal → termalo
terminado → fino
terminal → terminatela, terminal
terminar → teirnai
termómetro → termometera
ternera → ternera
ternura → aile
terracota → terracota
terraformación → terraforma
terraformar → terraformei
terraplén → terrapova
terraza → terraztela
terremoto → terraxatai
terrenal → terranal
terreno → terranno
territorio → territoria
terror → terura
terrorista → terurasta
tesis → tesis
teta → burra
tetronimo → tetronimo
texto zalgo → zalgo
texto → izkrebo
teñir → tentai
tiburón → tsonder, esqalo
tiempo (clima) → vedo
tiempo → tempo
tienda → kompraitela
tierno → aile
tierra infértil → hace
tierra → terra
tifón → tifona
tigre → tigra
tijera → akutoro
tiki → tiki
timbre → pistila
tinta → tenta
tio, tia → teo
tipo (de tipo de cosa) → tipe
tipo (ejemplar) → klase
tipo (forma) → forma
tipo (referencia coloquial a una persona) → pal
tira → estriga
tirar → atai
tiro → ata
titanio → titanno
titular → mantse
tiza → zirra
toalla → toaia
toallita → toaita
tobillo → kidna
tocar → toutsoi
toda forma → aldeforma
todavía → enoun
todavía → enoun
todo (cosas)→ aldex
todo momento, siempre → ertsai
todo → aldex
todos (personas) → aldexet
todos sitios, todos lados → aldetela, aldelocato
todoterreno → aldeterranno, forbafor
tomar → tomei
tomate → tomako
tono → tona
tonto → erko, silki
topo → talpa, mola
tormenta → zundra
tornado → tornado
torneo → torneio
tornillo → exkrabo
torno → torno
toro → toro
torpedo → torpedo
torre → torra
torta → torta
tortilla → tortilla, omeleto
tortita → tortite
tortuga → tortoisa
tortura → apunda
torturar → apunderai
totem → totem
trabajador → travaxeko
trabajador → travaxette
trabajar → travaxei
trabajo → travaxo, laboro
traducción → translaio
traducir → translai
traductor (objeto) → translaioro
traductor (persona) → translaixette
traer → brogei
traficación → trafike
traficante → trafikaxette
traficar → trafikai
traicionar → trastai
traicionero → trastoso
traición → trasta
traje → gouno, esmokinno
trampa → trapa, trapitsa
trampear → trapai
tranquilo → einxo
transcribir → transcribei
transcripción → transcriba
transcriptiva → transcribiko
transexual → transexualo
transexualidad → transexualita
transitar → transitei
transmutación → transmuta
transmutar → transmutai
transportador (regla) → aconvo
transportar → aconvoi
transportar, desplazar → deksplozai
transporte → conve
tranvía → ciutrena
tras → tras
trastornante → yigoiko
trastornar → yigai
trastorno → yiga
tratar → traire, tiskai
trato → tiska, trao
trece → dizitriai
treinta → triaien
tren → trena
trenza → trence
tres → triai
tres → triai
triciclo → trirroda
tridente → tridento
trigo → trego
trillón → trilloe
trinchera → trintsera
tripa → tripa
triplicar → triproxei
trismo → trisma
triste → tristeko
tristeza → tristaga
tristeza → tristekia
trituradora → trituoro
triturar → trituroi
triángulo → trianglo
trompa → trompo
trompeta → trompeta
tronar → trumbai
tronco → trunko
trono → trone
tropa → tropas
trucha → trutsa
truco → truka, trapitsa
trueno → trumbe
trufa → turfa
truncar → truncai
tráfico → trafiko
tránsito → transita
tsunami → tsunami, tzunami, zunami
tu/tuyo → zui
tubería → tubia
tubo → tube
tubérculo → tuberculo
tuerca → exkronno
tulipán → atulipa
tumba → tumba
tumor → tumor
tundra → kolfisi
tungsteno → tunsten
tupla → tupla
turismo → turisma
turista → turista
turnar → turnoi
turno → turno
turrón → bengela
té → tsa
técnica → texna
técnico → texnette
tímpano → timpano
tío → benpai
título → titula
tú → zu
ubicación → ubikatio, locato
ucrania → ukrania
ultimo → elasto
un, una, uno, unos, unas → am
unido → yoiko
unir → yoi
universidad → formatio-zentro
universo → universo
unión → unione
unión → yoixo
uno → one
uno → one
uperisado → uperisato
uranio → uranio
urano → urano
urbanización → urbo
urbano → urbe
uretra → uretra
uruguay → uruguai
usar → usei
uso → use
usted -> zeu
usual → usuala
usuario → usuario
utero → utero
utilidad → utilidae
uva → uba
vaca → vaka
vacante → vakante
vacío → aucuo
vacío → vatio
vago → sugarra
vago → sugarra
vagón → bagon, wagon
vajilla → vadixa
vale → bai
valer → valei
validar → validai
validez → valita
valla → berja, fenza
valle → vale
valor (tener fuerza de voluntad) → valia
valor (valor de algo) → valua
valorado → valuako
valorar → valuai
variable → variable
variar → varei
varios → eixamete, vari
varita → vando
varsovia → varsova
vasallaje → vasaia
vasallo → vasaio
vasija → vasiya
vaso → cupa
vecinal → neiborako
vecindario → neiborotela
vecino → neiboro
vehículo → vehiklo
veinte → doisen
vejez → okoie
vela → candala
velcro → velcro
velero → sivera
velocidad → velocita
vena → sigraconve, siger
venda → ladepipra, bande
vendar → bandei
vendedor → ventette
vender → ventei
venecia → veniza
veneno → venemo, ponzo
venezuela → venezola
venganza → revenga, revenganze
vengarse → revengai
venir → narei
ventana → vendexa
ventilador → vendoioro
ventrilocuo → vintrelocuo
venus → venux
ver, visualizar → visoi
verano → solasta
verbo → verba
verdad → verdad
verdad → verta
verdaderamente → zertente
verdadero → verdadeko
verde → berde
verdura → leguma
vergüenza → combro
verificación → verifia
verificado → verifeko
verificar → verifei
verruga → burgua
versión → versiona
versus → versus
vertedero → zorrotela, desextela
verter → verdai
vestido → venaza, dreso, gouno, zitaba
vestimenta → venaza
vestir → vanaize
vetar → paine, banai
veto → bana, paina, paine
vez → meto, vex
via → via
viajar → vixei
viaje → vixe
vibrador → vibraibo
vibrar → vibrai
vida → vita
videojuego → vidiojoko
viejo → igerne, elde
viejo, anciano → igerne
viento → vendo
vientre → vintre
viernes → vernia
vih → vih
villa → vila
vinagre → vinagra
vinilo → vinilo
vino → vino
violeta → violeta
violín → violinne
virgen → virgo
virginidad → virginitae
viruela → viraela
virus → virus
visado → visado
visitar → visitei
visión → viso
vislumbrar → zovisai, zintaire
vista → vista
visualización → visoatio
vitalidad → vitalita
vitamina → vitamine
viuda negra → viutonekro
viudo, viuda → viuto
vivienda → vivaitela
vivir → vivai
vivo → vitoso
vocabulario → vokabulatio
vocal → vokal
volante (coche) → volante
volante (papel) → piprako
volar → blai
volcán → volkano
volver → barei
vomitar, potar → resoltai, pukai, pukaire
vosotros → zure
voz → voz
vuelo → blaia
vuelta → vira
vuestro → zurei
vulva → vulve
válido → valo, valito
váscula → vascula
váter, retrete → batro, baxete, vater
vía → kemno
vídeo → vidio
web → web
whisky → wiski
wikipedia → wikipedia
xenón → xenon
xilófono → xelofono
ya no → nomais
ya → aia
yak → yak
yegüa → yequa
yero, algarroba → yero
yo → na
yunque → herrunna
zanahoria → carrota
zapatilla, zapato → poire
zombie → zombie
zona → zone
zoológico → zoologiko
zorro → zunio, fokso
zumbido → biz
zumo → xugino, bubo
zurdo → zoranno
¡mira! → siet (ejemplo: mira, estoy haciendo un trabajo de ciencias)
ácaro → atiko
áfrica → afrika
águila → egila
álamo → klisila
ángel → anyel
árabe → arabeka
árbol → arbotso
áspero → coarsa
ático → airgaizera
épico → epikar
época → elkara
ética → etika
ícor → icor
ímbolo , signos → simo
índigo → indigo
ñú → legas
óculo → oculo
óleo → oliuma
ósmosis → osmosis
óvalo → oval
óvulo → ovulo
óxido → ragi
úlcera → ulcera
último → finale
único → uniko
útil → utila